# Russian-English translations created from the Universal dictionary at 2012-11-22T08:09:02-07:00
# (c) Copyright 2012 by All free dictionaries project
# ALL FREE DICTIONARIES PROJECT DISCLAIMS ALL
# WARRANTIES WITH REGARD TO THESE TRANSLATIONS, INCLUDING ALL
# IMPLIED WARRANTIES OF MERCHANTABILITY AND FITNESS. IN NO
# EVENT SHALL ALL FREE DICTIONARIES PROJECT OR ANY OF ITS CONTRIBUTORS
# BE LIABLE FOR ANY SPECIAL, INDIRECT OR CONSEQUENTIAL DAMAGES
# OR ANY DAMAGES WHATSOEVER RESULTING FROM LOSS OF USE, DATA OR
# PROFITS, WHETHER IN AN ACTION OF CONTRACT, NEGLIGENCE
# OR OTHER ACTION, ARISING OUT OF OR IN CONNECTION
# WITH THE USE OR PERFORMANCE OF THESE TRANSLATIONS.
#
# In other words there may be incorrect translations.
# If you need to be sure never use these translations!
#
# French, German and Czech entries are added manually. The entries for
# remaining languages are added automatically. Entries for these languages
# are only experimental.
#
# You may not place this file on WWW, ftp and equivalent servers because
# this file gets outdated very quickly. You may not distribute this file
# with your dictionary applications without permission. You can contact
# authors of the Universal dictionary at: http://dicts.info/contact.php
#
# This file is for personal use only. You may not distribute this file.
#
# New version of this file can be created at: http://www.dicts.info/uddl.php
#

 povorod 	 bend ; curve 	 transport 
 poпробовать 	 taste ; savor ; savour 	 verb 
 tакже ; тоже 	 besides ; too ; also ; likewise ; as well 	 adverb 
 ''not used'' 	 the 	 article 
 Англия ; Великобритания 	 United Kingdom ; UK ; U.K. ; Britain ; United Kingdom of Great Britain and Northern Ireland ; Great Britain 	 country 
 Германия 	 Germany ; Federal Republic of Germany ; Deutschland ; FRG 	 country 
 Земля 	 Earth ; earth ; world ; globe 	 nature 
 Индия 	 India ; Republic of India ; Bharat 	 country 
 Испания 	 Spain ; Kingdom of Spain ; Espana 	 country 
 Италия 	 Italy ; Italian Republic ; Italia 	 country 
 США ; Соединенные Штаты Америки 	 United States ; United States of America ; America ; the States ; US ; U.S. ; USA ; U.S.A. 	 country 
 Франция 	 France ; French Republic 	 country 
 Чехия ; Чешская Республика 	 Czech Republic 	 country 
 Япония 	 Japan ; Nippon ; Nihon 	 country 
 автобус 	 bus ; autobus ; coach ; charabanc ; double-decker ; jitney ; motorbus ; motorcoach ; omnibus ; passenger vehicle 	 transport 
 автоматический 	 automatic 	 adjective 
 автомобиль ; машина 	 car ; auto ; automobile ; machine ; motorcar 	 transport 
 авторитет 	 authority ; authorization ; authorisation ; potency ; dominance ; say-so 	 society 
 адрес 	 address 	 abstract 
 актриса 	 actress 	 profession 
 актёр 	 actor ; histrion ; player ; thespian ; role player 	 profession 
 акция 	 share 	 business 
 альтернатива 	 option ; alternative ; choice 	 abstract 
 английский язык 	 English ; English language 	 language 
 апельсин 	 orange 	 food 
 апрель 	 April ; Apr 	 time 
 аргумент 	 argument ; statement 	 communication 
 аргументировать 	 argue ; reason 	 verb 
 арифмометр ; счётчик 	 calculator ; reckoner ; figurer ; estimator ; computer 	 device 
 армия 	 army ; regular army ; ground forces 	 society 
 армия 	 military ; armed forces ; armed services ; military machine ; war machine 	 society 
 аспект 	 aspect 	 abstract 
 атаковать 	 assail ; assault ; set on ; attack 	 verb 
 аэродром ; аэропорт 	 airport ; airdrome ; aerodrome ; drome 	 city 
 баланц 	 balance 	 physics 
 банк 	 depository financial institution ; bank ; banking concern ; banking company 	 city 
 банкнот ; кредитный билет 	 bill ; note ; government note ; bank bill ; banker's bill ; bank note ; banknote ; Federal Reserve note ; greenback 	 business 
 бдительный 	 awake 	 adjective 
 бедный 	 poor 	 adjective 
 бежать 	 run 	 verb 
 безобразный ; некрасивый 	 ugly 	 adjective 
 безопасный 	 dependable ; good ; safe ; secure 	 adjective 
 безработный 	 unemployed 	 adjective 
 бейсбол 	 baseball ; baseball game 	 sports 
 белый 	 white 	 adjective 
 берег 	 bank 	 nature 
 бесплатный 	 complimentary ; costless ; free ; gratis ; gratuitous 	 adjective 
 библиотека 	 library 	 city 
 бизнесмен 	 businessman ; man of affairs 	 profession 
 билет 	 ticket 	 object 
 билет 	 ticket 	 object 
 биология 	 biology ; biological science 	 science 
 бич 	 whip 	 object 
 благодарить 	 thank ; give thanks 	 verb 
 близкий ; недалёкий 	 near ; close ; nigh 	 adjective 
 блюдо ; еда 	 meal ; repast 	 food 
 блюдо ; питание 	 food ; nutrient 	 food 
 более ; болше 	 more ; more than 	 adjective 
 более ; болше 	 more ; to a greater extent 	 adverb 
 болезнь 	 disease 	 medicine 
 боль 	 pain ; hurting 	 medicine 
 больница 	 hospital ; infirmary 	 city 
 больной 	 ill ; sick 	 adjective 
 большинство 	 majority ; bulk 	 abstract 
 большой ; великий 	 great 	 adjective 
 большой палец 	 thumb ; pollex 	 anatomy 
 большой чан ; спина 	 back ; dorsum 	 anatomy 
 борьба 	 fight ; fighting ; combat ; scrap 	 abstract 
 ботинок 	 boot 	 clothes 
 ботинок 	 shoe 	 clothes 
 бояться 	 fear 	 verb 
 брак 	 marriage ; matrimony ; union ; spousal relationship ; wedlock 	 society 
 брак 	 marriage ; wedding ; marriage ceremony 	 family 
 брак 	 wedding ; wedding ceremony ; nuptials ; hymeneals 	 family 
 брат 	 brother ; blood brother 	 family 
 брешь 	 crack ; cleft ; crevice ; fissure ; scissure 	 abstract 
 бросание 	 throw 	 sports 
 бросать ; кидать 	 throw 	 verb 
 будущее 	 future ; hereafter ; futurity ; time to come 	 time 
 будущий 	 future 	 adjective 
 буква 	 letter ; letter of the alphabet ; alphabetic character 	 linguistics 
 буксовка 	 skid ; slip ; sideslip 	 abstract 
 булавка 	 pin 	 object 
 бумага 	 paper 	 material 
 бутылка 	 bottle 	 food 
 бывший 	 erstwhile ; former ; old ; onetime ; one-time ; quondam ; sometime 	 adjective 
 быстро 	 quickly ; rapidly ; speedily ; chop-chop ; apace 	 adverb 
 быстрый 	 fast 	 logistics 
 быть 	 be 	 verb 
 быть 	 exist ; be 	 verb 
 в 	 into 	 preposition 
 в течение 	 during 	 preposition 
 важный 	 authoritative ; important 	 adjective 
 важный 	 important ; of import 	 adjective 
 важный 	 meaning ; pregnant ; significant 	 adjective 
 важный 	 significant ; important 	 adjective 
 ванна 	 bath 	 house 
 ванная 	 bathroom ; bath 	 house 
 варить 	 cook 	 verb 
 вверх 	 up ; upwards ; upward ; upwardly 	 adverb 
 вдоль 	 along 	 adverb 
 вдруг 	 suddenly ; all of a sudden ; of a sudden 	 adverb 
 век 	 century 	 time 
 велосипед 	 bicycle ; bike ; wheel ; cycle 	 object 
 верить 	 believe 	 verb 
 вернуть 	 render ; return 	 verb 
 верный 	 certain ; sure 	 adjective 
 вероисповедание 	 religion ; faith ; religious belief 	 society 
 вероятно 	 probably ; likely ; in all likelihood ; in all probability ; belike 	 adverb 
 вероятный 	 probable ; likely 	 adjective 
 верхушка 	 acme ; height ; elevation ; peak ; pinnacle ; summit ; superlative ; meridian ; tiptop ; top 	 abstract 
 вес 	 weight 	 physics 
 веселье ; развлечение ; забава ; увеселение 	 entertainment ; amusement 	 art 
 весна 	 spring ; springtime 	 nature 
 вести 	 lead ; head 	 verb 
 вести 	 manage ; deal ; care ; handle 	 verb 
 весь ; целый 	 full ; total 	 adjective 
 весь ; целый 	 whole 	 adjective 
 ветвь 	 branch 	 nature 
 ветер 	 wind ; air current ; current of air 	 nature 
 вечер 	 evening ; eve ; even ; eventide 	 time 
 вечеринка 	 party 	 society 
 вещество 	 matter 	 material 
 взвешивать(ся) 	 weigh 	 verb 
 взгорье ; холм 	 hill 	 nature 
 взять ; брать 	 take ; get hold of 	 verb 
 вид 	 kind ; sort ; form ; variety 	 abstract 
 вид ; взгляд 	 expression ; look ; aspect ; facial expression ; face 	 communication 
 видеть 	 see 	 verb 
 визит 	 visit 	 abstract 
 вилка 	 fork 	 food 
 вино 	 wine ; vino 	 food 
 включать 	 imply ; involve 	 verb 
 включить 	 include 	 verb 
 включённый 	 on 	 adjective 
 вкус 	 taste ; gustation ; sense of taste ; gustatory modality 	 nature 
 владеть 	 own ; have ; possess 	 verb 
 влажность 	 moisture ; wet 	 nature 
 вместе 	 together 	 adverb 
 вместо 	 alternatively ; instead ; or else 	 adverb 
 внимание 	 attention ; attending 	 communication 
 внутри 	 inside ; within 	 adverb 
 внутрь ; в ; до 	 in ; inwards ; inward 	 adverb 
 вода 	 water ; H2O 	 material 
 водить 	 drive 	 verb 
 военная база 	 base ; base of operations 	 society 
 военный 	 military 	 adjective 
 возврат 	 return ; homecoming 	 abstract 
 воздух 	 air 	 nature 
 возможность 	 opportunity ; chance 	 abstract 
 возможный 	 possible 	 adjective 
 возражать ; протестовать 	 protest 	 verb 
 возраст 	 age 	 time 
 возраст 	 historic period ; age 	 time 
 война 	 war ; state of war 	 society 
 волна 	 wave ; moving ridge 	 nature 
 волна ; шерсть 	 wool 	 material 
 волос ; ворс 	 hair ; pilus 	 anatomy 
 волосы 	 hair 	 anatomy 
 воля 	 volition ; will 	 abstract 
 воля 	 will 	 society 
 вонять 	 smell 	 verb 
 вопрос 	 question ; inquiry ; enquiry ; query ; interrogation 	 linguistics 
 ворота ; калитка 	 gate 	 house 
 воротник ; туфля 	 collar ; neckband 	 clothes 
 восемнадцать 	 eighteen ; 18 ; xviii 	 number 
 восемь 	 eight ; 8 ; viii 	 number 
 восемьдесят 	 eighty ; 80 ; lxxx ; fourscore 	 number 
 воскресенье 	 Sunday ; Lord's Day ; Dominicus ; Sun 	 time 
 воспитание 	 education 	 society 
 воспитать 	 rear ; raise ; bring up ; nurture ; parent 	 verb 
 воспоминание 	 memory 	 communication 
 восточный 	 east 	 adjective 
 восьмой 	 eighth ; 8th 	 number 
 вперед 	 earlier ; before 	 adverb 
 впереди 	 ahead ; in front ; before 	 adverb 
 вперёд 	 forward ; forwards ; frontward ; frontwards ; forrad ; forrard 	 adverb 
 впечатление 	 experience 	 communication 
 врач ; доктор 	 doctor ; doc ; physician ; MD ; Dr. ; medico 	 profession 
 времена года 	 season 	 nature 
 время 	 fourth dimension ; time 	 physics 
 время после полудня 	 afternoon 	 time 
 вручить 	 deliver 	 verb 
 все 	 everything 	 pronoun 
 все ; бсё 	 all 	 adjective 
 всегда 	 always ; ever ; e'er 	 adverb 
 всеобщий ; общий 	 general 	 adjective 
 всерьёз 	 truly ; genuinely ; really 	 adverb 
 встать 	 get up 	 verb 
 встреча 	 meeting ; coming together 	 communication 
 встреча ; свидание 	 date ; appointment ; engagement 	 relations 
 встречать(ся) 	 meet ; run into ; encounter ; run across ; come across ; see 	 verb 
 вступить 	 enter ; come in ; get into ; get in ; go into ; go in ; move into 	 verb 
 вторая степень 	 square ; second power 	 mathematics 
 второй 	 second ; 2nd ; 2d 	 adjective 
 выбор 	 choice ; selection ; option ; pick 	 abstract 
 выборы 	 election 	 mathematics 
 выбрать 	 choose ; take ; select ; pick out 	 verb 
 выиграть ; победить 	 win 	 verb 
 выключенный 	 off 	 adjective 
 вымыть 	 wash ; launder 	 verb 
 выработать 	 process ; treat 	 verb 
 выравнить 	 flush ; level ; even out ; even 	 verb 
 выразить 	 express ; state 	 verb 
 высокий 	 high 	 adjective 
 высокий 	 tall 	 adjective 
 высота 	 altitude ; height 	 abstract 
 высоцхнуть 	 dry ; dry out 	 verb 
 высушить 	 dry ; dry out 	 verb 
 высчитать 	 number 	 verb 
 выход 	 east ; due east ; eastward ; E 	 logistics 
 выходных 	 weekend 	 time 
 газета 	 newspaper ; paper 	 object 
 гайка 	 nut 	 object 
 галстук 	 necktie ; tie 	 clothes 
 гараж 	 garage 	 transport 
 гвоздь 	 nail 	 object 
 ген 	 gene ; cistron ; factor 	 anatomy 
 генерал 	 general ; full general 	 profession 
 гитара 	 guitar 	 object 
 главный 	 chief ; main ; primary ; principal ; master 	 adjective 
 главный 	 major 	 adjective 
 гладкий 	 smooth 	 adjective 
 глаз 	 eye ; oculus ; optic 	 anatomy 
 глотка ; зев ; горло 	 throat ; pharynx 	 anatomy 
 глубокий 	 deep 	 adjective 
 глупый 	 airheaded ; dizzy ; empty-headed ; featherbrained ; giddy ; light-headed ; lightheaded ; silly 	 adjective 
 глупый 	 stupid 	 adjective 
 глянцевать 	 polish ; smooth ; smoothen ; shine 	 verb 
 говорить 	 state ; say ; tell 	 verb 
 говорить 	 talk ; speak ; utter ; mouth ; verbalize ; verbalise 	 verb 
 год 	 year ; twelvemonth ; yr 	 time 
 гол 	 goal 	 sports 
 голова 	 head ; caput 	 anatomy 
 голодный 	 hungry 	 adjective 
 голос 	 voice ; vocalization ; vocalisation ; vocalism ; phonation ; vox 	 communication 
 голубой 	 blue ; bluish ; blueish 	 color 
 гольф 	 golf ; golf game 	 travelling 
 гон 	 estrus ; oestrus ; heat ; rut 	 nature 
 гора 	 mountain ; mount 	 nature 
 город 	 town 	 society 
 горький 	 bitter 	 adjective 
 горячий 	 hot 	 adjective 
 господство 	 dominion ; rule 	 society 
 гостиница ; отель 	 hotel 	 city 
 гость 	 guest ; invitee 	 travelling 
 готовить 	 cook ; fix ; ready ; make ; prepare 	 verb 
 готовый ; приготовленный 	 ready 	 adjective 
 граница ; лимит 	 limit ; bound ; boundary 	 mathematics 
 громкий 	 loud 	 adjective 
 грубый 	 crude ; rough 	 adjective 
 грубый 	 rough ; unsmooth 	 adjective 
 грудная клетка ; грудь 	 thorax ; chest ; pectus 	 anatomy 
 грудь 	 breast ; chest 	 anatomy 
 группа 	 group ; grouping 	 abstract 
 грустный 	 deplorable ; distressing ; lamentable ; pitiful ; sad ; sorry 	 adjective 
 грязный 	 dirty ; dingy ; muddied ; muddy 	 adjective 
 грязный 	 dirty ; soiled ; unclean 	 adjective 
 губа 	 lip 	 anatomy 
 гуманный 	 human 	 adjective 
 густой 	 thick 	 adjective 
 да 	 yes 	 abstract 
 давать 	 give 	 verb 
 давать отпор ; противостоять 	 confront ; face up ; face 	 verb 
 давление 	 pressure ; pressure level ; force per unit area 	 nature 
 даже 	 even 	 adverb 
 дальше 	 further ; farther 	 adjective 
 далёкий 	 far 	 adjective 
 данный ; установленный 	 fixed 	 adjective 
 дата ; число 	 date ; day of the month 	 time 
 два 	 two ; 2 ; ii 	 number 
 двадцать 	 twenty ; 20 ; xx 	 number 
 двенадцатый 	 twelfth ; 12th 	 number 
 дверь ; створка 	 door 	 house 
 двигатель 	 engine 	 device 
 двигать 	 move ; displace 	 verb 
 движение 	 motion ; movement ; move ; motility 	 physics 
 движение 	 movement ; motion 	 physics 
 девочка ; поклонница 	 girlfriend ; girl ; lady friend 	 family 
 девушка ; девочка 	 girl ; miss ; missy ; young lady ; young woman ; fille 	 family 
 девяносто 	 ninety ; 90 ; xc 	 number 
 девятнадцать 	 nineteen ; 19 ; xix 	 number 
 девятый 	 ninth ; 9th 	 number 
 девять 	 nine ; 9 ; ix 	 number 
 дедушка 	 grandfather ; gramps ; granddad ; grandad ; granddaddy ; grandpa 	 family 
 действие 	 operation ; functioning ; performance 	 mathematics 
 действительно 	 actually ; really 	 adverb 
 действительно ; серьезно 	 indeed ; so 	 adverb 
 действительный 	 real ; existent 	 adjective 
 действовать 	 act ; move 	 verb 
 декабрь 	 December ; Dec 	 time 
 декорация 	 decoration ; ornament ; ornamentation 	 object 
 делать 	 make ; do 	 verb 
 деликатный ; щекотливый 	 delicate 	 adjective 
 дело 	 act ; deed ; human action ; human activity 	 abstract 
 дело 	 matter ; affair ; thing 	 abstract 
 дело 	 work ; piece of work 	 abstract 
 дело ; труда ; работа 	 job ; task ; chore 	 business 
 демократия ; республика 	 democracy ; republic ; commonwealth 	 society 
 день 	 day ; twenty-four hours ; twenty-four hour period ; 24-hour interval ; solar day ; mean solar day 	 nature 
 день рождения 	 birthday 	 family 
 деньги 	 money 	 business 
 деньги 	 money 	 transport 
 деревня 	 village ; hamlet 	 society 
 деревня 	 village ; small town ; settlement 	 society 
 дерево 	 tree 	 house 
 дерево 	 wood 	 material 
 держать 	 hold ; take hold 	 verb 
 десятый 	 tenth ; 10th 	 number 
 десять 	 ten ; 10 ; x 	 number 
 дешевый 	 cheap ; inexpensive 	 adjective 
 деятельность 	 action ; activity ; activeness 	 mathematics 
 диапазон 	 scope ; range ; reach ; orbit ; compass ; ambit 	 abstract 
 диетический 	 light ; lite ; low-cal ; calorie-free 	 adjective 
 директор 	 director ; manager ; managing director 	 profession 
 дискутировать 	 hash out ; discuss ; talk over 	 verb 
 диспут ; прения ; беседа 	 discussion ; give-and-take ; word 	 communication 
 дисциплина 	 discipline ; subject ; subject area ; subject field ; field ; field of study ; study ; bailiwick 	 linguistics 
 длинный 	 long 	 adjective 
 длинный 	 long 	 adjective 
 до 	 until 	 conjunction 
 добро 	 good ; goodness 	 abstract 
 довольно 	 enough ; plenty 	 adverb 
 довольно 	 quite ; rather 	 adverb 
 дождить ; идёт дождь 	 rain ; rain down 	 verb 
 дождь 	 rain ; pelting 	 nature 
 дождь 	 rain ; rainfall 	 nature 
 доказать 	 testify ; bear witness ; prove ; evidence ; show 	 verb 
 дом 	 dwelling ; home ; domicile ; abode ; habitation ; dwelling house 	 house 
 дом 	 house 	 house 
 дополнение 	 addition ; add-on ; improver 	 abstract 
 дорога ; путь 	 road ; route 	 transport 
 дорогой ; дорогая 	 beloved ; dear ; dearest ; honey ; love 	 relations 
 доска 	 board 	 object 
 доставить 	 transport ; send ; ship 	 verb 
 достигать 	 achieve ; accomplish ; attain ; reach 	 verb 
 достичь 	 reach ; make ; attain ; hit ; arrive at ; gain 	 verb 
 доступный 	 available 	 adjective 
 досягаемость 	 range ; reach 	 abstract 
 дочь 	 daughter ; girl 	 family 
 драгоценность 	 jewel ; gem ; precious stone 	 object 
 драться 	 contend ; fight ; struggle 	 verb 
 дрессировать 	 train ; develop ; prepare ; educate 	 verb 
 дрожание 	 tremble ; shiver ; shake 	 abstract 
 друг 	 friend 	 family 
 другой 	 another ; some other 	 adjective 
 другой 	 different 	 adjective 
 другой 	 different 	 adjective 
 другой 	 other 	 adjective 
 дружеский 	 friendly 	 adjective 
 дубинка 	 club 	 object 
 думать 	 mean ; intend 	 verb 
 думать 	 think ; cogitate ; cerebrate 	 verb 
 душ 	 shower 	 house 
 дым 	 smoke ; fume 	 nature 
 дыра 	 hole 	 abstract 
 дыхание 	 breath 	 anatomy 
 его 	 him 	 pronoun 
 его 	 his 	 pronoun 
 его 	 its 	 pronoun 
 единица 	 unit of measurement ; unit 	 mathematics 
 единочный 	 individual ; private 	 adjective 
 единственный 	 single 	 adjective 
 если 	 if 	 conjunction 
 есть 	 eat 	 verb 
 её 	 her 	 pronoun 
 жаждущий 	 thirsty 	 adjective 
 жалкий ; жалобный 	 hapless ; miserable ; misfortunate ; pathetic ; piteous ; pitiable ; pitiful ; poor ; wretched 	 adjective 
 жара 	 hotness ; heat ; high temperature 	 medicine 
 ждать 	 expect ; look ; await ; wait 	 verb 
 ждать 	 wait ; hold off ; hold back 	 verb 
 желание 	 wish ; wishing ; want 	 abstract 
 железо 	 iron ; Fe ; atomic number 26 	 material 
 желудок 	 stomach ; tummy ; tum ; breadbasket 	 anatomy 
 жена 	 wife ; married woman 	 family 
 женатый 	 married 	 adjective 
 жениться 	 marry ; get married ; wed ; conjoin ; hook up with ; get hitched with ; espouse 	 verb 
 женский 	 female 	 adjective 
 женщина 	 female ; female person 	 society 
 женщина 	 woman ; adult female 	 family 
 жестокий 	 barbarous ; brutal ; cruel ; fell ; roughshod ; savage ; vicious 	 adjective 
 живой 	 alive ; live 	 adjective 
 животное 	 animal ; animate being ; beast ; brute ; creature ; fauna 	 nature 
 жидкий 	 liquid 	 adjective 
 жидкость 	 liquid 	 nature 
 жизнь 	 life 	 nature 
 жизнь 	 life 	 time 
 жилище ; дом 	 home ; place 	 house 
 жир 	 fat 	 material 
 жирный 	 fatty ; fat 	 adjective 
 жить 	 be ; live 	 verb 
 журнал 	 magazine ; mag 	 object 
 журналист ; газетный сотрудник 	 journalist 	 profession 
 жёлтый 	 yellow ; yellowish ; xanthous 	 color 
 жёсткий 	 solid 	 adjective 
 жёсткий ; негнущийся 	 rigid ; stiff 	 adjective 
 за 	 beyond 	 adverb 
 заботиться 	 care 	 verb 
 заботиться 	 heed ; mind ; listen 	 verb 
 забыть ; забывать 	 forget 	 verb 
 завести 	 lead ; take ; direct ; conduct ; guide 	 verb 
 завещание 	 will ; testament 	 society 
 завод 	 factory ; mill ; manufacturing plant ; manufactory 	 city 
 завод ; фабрика 	 plant ; works ; industrial plant 	 city 
 завтра 	 tomorrow 	 adverb 
 завтрак 	 breakfast 	 food 
 завтрашний день ; завтра 	 tomorrow 	 time 
 загиб 	 fold ; crease ; plication ; flexure ; crimp ; bend 	 object 
 заглавная буква 	 capital ; capital letter ; uppercase ; upper-case letter ; majuscule 	 linguistics 
 задняя страница 	 back 	 clothes 
 заключать в себе ; охватывать 	 embrace ; encompass ; comprehend ; cover 	 verb 
 заключать в себе ; охватывать 	 incorporate ; contain ; comprise 	 verb 
 заключение ; решение 	 decision ; determination ; conclusion 	 communication 
 закон 	 law 	 society 
 законный 	 legal 	 adjective 
 закончить ; докончить 	 complete ; finish 	 verb 
 закрывать 	 close ; shut 	 verb 
 закрытый 	 shut ; unopen ; closed 	 adjective 
 закрыть 	 shroud ; enshroud ; hide ; cover 	 verb 
 зал суда 	 court ; courtroom 	 society 
 замена 	 substitution ; exchange ; commutation 	 abstract 
 заменить 	 supplant ; replace ; supersede ; supervene upon ; supercede 	 verb 
 заместитель 	 representative 	 profession 
 заметка 	 note ; annotation ; notation 	 communication 
 замечательный 	 bang-up ; bully ; corking ; cracking ; dandy ; great ; groovy ; keen ; neat ; nifty ; not bad ; peachy ; slap-up ; swell ; smashing 	 adjective 
 замечательный 	 excellent ; first-class ; fantabulous ; splendid 	 adjective 
 замкнуть 	 lock 	 verb 
 замок 	 lock 	 house 
 замок ; кремль 	 castle 	 city 
 замышлять 	 intend ; mean ; think 	 verb 
 занавеска 	 curtain ; drape ; drapery ; mantle ; pall 	 house 
 занятие ; торговля 	 trade 	 business 
 запад 	 west ; due west ; westward ; W 	 logistics 
 западный 	 west 	 adjective 
 запах 	 olfactory property ; smell ; aroma ; odor ; odour ; scent 	 nature 
 записать 	 record ; tape 	 verb 
 запустить 	 fail ; neglect 	 verb 
 заряд 	 charge ; electric charge 	 nature 
 зарядить 	 load ; charge 	 verb 
 звезда 	 star 	 nature 
 звонить 	 call ; telephone ; call up ; phone ; ring 	 verb 
 звонок ; зов ; оклик 	 call ; phone call ; telephone call 	 communication 
 звук 	 audio ; sound 	 abstract 
 звук 	 sound 	 nature 
 здание 	 building ; edifice 	 city 
 здесь ; тут 	 here 	 adverb 
 здоровый 	 good ; sound 	 adjective 
 здоровый 	 healthy 	 adjective 
 здоровый 	 healthy ; salubrious ; good for you 	 adjective 
 здоровье 	 health 	 abstract 
 здоровье 	 health ; wellness 	 medicine 
 зелёный 	 green ; greenish ; light-green ; dark-green 	 color 
 земля 	 earth ; ground 	 material 
 земля ; почва 	 land ; dry land ; earth ; ground ; solid ground ; terra firma 	 nature 
 зеркало 	 mirror 	 house 
 зерно 	 grain 	 material 
 зерно ; семя 	 seed 	 food 
 зима 	 winter ; wintertime 	 nature 
 змея 	 snake ; serpent ; ophidian 	 animal 
 знак 	 character ; grapheme ; graphic symbol 	 linguistics 
 знак 	 sign 	 linguistics 
 знание 	 cognition ; knowledge ; noesis 	 education 
 знать 	 know ; cognize ; cognise 	 verb 
 золото 	 gold ; Au ; atomic number 79 	 material 
 золотой ; золотистий 	 aureate ; gilded ; gilt ; gold ; golden 	 color 
 зуб 	 tooth 	 anatomy 
 и 	 and 	 conjunction 
 ибо 	 for 	 conjunction 
 иголка ; игла 	 needle 	 medicine 
 игра 	 game 	 mathematics 
 игра 	 game 	 sports 
 играть 	 play 	 verb 
 игрок 	 player ; participant 	 sports 
 идти 	 walk 	 verb 
 идёт снег 	 snow 	 verb 
 извержение 	 outburst ; burst ; flare-up 	 abstract 
 изготовить 	 produce ; make ; create 	 verb 
 издать 	 publish ; bring out ; put out ; issue ; release 	 verb 
 изменить 	 change ; alter ; modify 	 verb 
 измерение 	 measurement ; measuring ; measure ; mensuration 	 art 
 износ 	 wear 	 abstract 
 изображение 	 picture ; image ; icon ; ikon 	 art 
 изобретение ; измышление ; вымысел 	 invention ; innovation ; excogitation ; conception ; design 	 art 
 изучать 	 study 	 verb 
 или 	 or 	 conjunction 
 иметь 	 have ; have got ; hold 	 verb 
 иметь значение 	 count ; matter ; weigh 	 verb 
 иметь наклонность 	 tend ; be given ; lean ; incline ; run 	 verb 
 имидж 	 image 	 art 
 имущество 	 property ; belongings ; holding 	 society 
 имя 	 name 	 linguistics 
 имя прилагательное 	 adjective 	 linguistics 
 индивидуум 	 individual 	 society 
 иногда 	 sometimes 	 adverb 
 иностранный 	 foreign ; strange 	 adjective 
 инструмент ; орудие 	 instrument 	 device 
 интерес 	 interest ; involvement 	 communication 
 интересный 	 interesting 	 adjective 
 интернет 	 internet ; net ; cyberspace 	 mathematics 
 искренний 	 sincere 	 adjective 
 искривление ; кривизна ; изгиб 	 curvature ; curve 	 mathematics 
 искусство 	 art ; fine art 	 art 
 искусство 	 skill ; science 	 sports 
 испанский язык 	 Spanish 	 language 
 использовать 	 use ; utilize ; utilise ; apply ; employ 	 verb 
 испытать 	 test ; prove ; try ; try out ; examine ; essay 	 verb 
 исследование 	 research 	 abstract 
 исследовать 	 research 	 verb 
 история 	 history 	 society 
 источник 	 beginning ; origin ; root ; rootage ; source 	 transport 
 источник 	 spring ; fountain ; outflow ; outpouring ; natural spring 	 nature 
 исходный ; оригинальный 	 original 	 adjective 
 итальянский язык 	 Italian 	 language 
 итог ; сумма 	 sum ; amount ; total 	 mathematics 
 их 	 their 	 pronoun 
 их 	 them 	 pronoun 
 июль 	 July 	 time 
 июнь 	 June 	 time 
 каждый 	 each 	 adjective 
 каждый 	 every 	 adjective 
 казаться 	 look ; appear ; seem 	 verb 
 как 	 equally ; as ; every bit 	 adverb 
 какой 	 which 	 pronoun 
 камера 	 television camera ; tv camera ; camera 	 object 
 кампания 	 campaign ; cause ; crusade ; drive ; movement ; effort 	 abstract 
 канат 	 rope 	 transport 
 каникулы 	 vacation ; holiday 	 travelling 
 капитал 	 capital ; working capital 	 business 
 капля 	 drop ; drib ; driblet 	 object 
 карандаш 	 pencil 	 object 
 карта 	 map 	 object 
 картина 	 painting ; picture 	 art 
 картофелина 	 potato ; white potato ; Irish potato ; murphy ; spud ; tater 	 food 
 карточка 	 card 	 object 
 качать 	 pump 	 verb 
 качество 	 quality 	 abstract 
 качество 	 quality ; character ; lineament 	 abstract 
 кашель 	 cough ; coughing 	 medicine 
 кашлять 	 cough 	 verb 
 квадрат 	 square ; foursquare 	 mathematics 
 квадратный 	 square 	 adjective 
 квартира 	 apartment ; flat 	 society 
 келья 	 cell ; jail cell ; prison cell 	 society 
 кино ; кинотеатр 	 cinema ; movie theater ; movie theatre ; movie house ; picture palace 	 city 
 кирпич 	 brick 	 house 
 кислота 	 acid 	 material 
 кислый 	 acid 	 adjective 
 китай 	 China ; People's Republic of China ; mainland China ; Communist China ; Red China ; PRC ; Cathay 	 country 
 китайский язык 	 Chinese 	 language 
 клавиша 	 key 	 object 
 класть 	 put ; set ; place ; pose ; position ; lay 	 verb 
 клеить 	 glue ; paste 	 verb 
 клей 	 glue ; gum ; mucilage 	 material 
 клейкий 	 gluey ; glutinous ; gummy ; mucilaginous ; pasty ; sticky ; viscid ; viscous 	 adjective 
 клуб 	 club ; social club ; society ; guild ; gild ; lodge ; order 	 society 
 клюв 	 beak ; bill ; neb ; nib ; pecker 	 anatomy 
 ключ 	 key 	 house 
 книга 	 book ; volume 	 object 
 книзу ; вниз 	 down ; downwards ; downward ; downwardly 	 adverb 
 кнопка 	 push button ; push ; button 	 object 
 ковёр 	 rug ; carpet ; carpeting 	 house 
 кого 	 whom 	 pronoun 
 кожа 	 leather 	 material 
 кожа 	 skin ; tegument ; cutis 	 anatomy 
 козёл ; коза 	 goat ; caprine animal 	 animal 
 коктейль 	 milkshake ; milk shake ; shake 	 food 
 колено 	 knee ; knee joint ; human knee ; articulatio genus ; genu 	 anatomy 
 колесо 	 wheel 	 object 
 количество 	 amount 	 abstract 
 количество 	 bulk ; mass ; volume 	 physics 
 количество ; число 	 number 	 linguistics 
 колодец 	 well 	 object 
 колокол 	 bell 	 object 
 кольцо 	 ring ; band 	 clothes 
 команда 	 team ; squad 	 society 
 комитет ; комиссия 	 committee ; commission 	 society 
 коммерция ; бизнес 	 business ; concern ; business concern ; business organization ; business organisation 	 business 
 коммутатор 	 central ; telephone exchange ; exchange 	 society 
 комната 	 room 	 house 
 комплект 	 set 	 sports 
 комплектный 	 complete ; consummate 	 adjective 
 компьютер 	 computer ; computing machine ; computing device ; data processor ; electronic computer ; information processing system 	 device 
 конверт 	 envelope 	 object 
 конец 	 end ; terminal 	 abstract 
 конечный 	 concluding ; final ; last ; terminal 	 adjective 
 конкуренция ; соревнование 	 competition 	 business 
 консерва 	 can ; tin ; tin can 	 object 
 контракт 	 contract 	 business 
 контролировать 	 control ; command 	 verb 
 конфигурация, форма 	 form ; shape ; cast 	 art 
 концерт 	 concert 	 art 
 кончать 	 end ; stop ; finish ; terminate ; cease 	 verb 
 копировать 	 copy ; re-create 	 verb 
 копить 	 save ; preserve 	 verb 
 копия 	 copy 	 object 
 коптить 	 fume ; smoke 	 verb 
 корень 	 root 	 mathematics 
 корень 	 root 	 nature 
 корзина 	 basket ; handbasket 	 object 
 коричневый 	 brown ; brownish ; chocolate-brown ; dark-brown 	 color 
 коробка 	 box 	 object 
 корова 	 cow ; moo-cow 	 animal 
 королевский 	 imperial ; majestic ; purple ; regal ; royal 	 adjective 
 король 	 king ; male monarch ; Rex 	 society 
 короткий 	 short 	 adjective 
 космос 	 space ; infinite 	 mathematics 
 кость 	 bone ; os 	 anatomy 
 кот ; кошка 	 cat ; true cat 	 animal 
 который 	 what 	 pronoun 
 кофе 	 coffee ; java 	 food 
 красивый 	 beautiful 	 adjective 
 красивый ; хороший 	 nice 	 adjective 
 краска 	 coloring material ; colouring material ; color ; colour 	 art 
 краска 	 paint ; pigment 	 art 
 красный 	 red ; reddish ; ruddy ; blood-red ; carmine ; cerise ; cherry ; cherry-red ; crimson ; ruby ; ruby-red ; scarlet 	 color 
 красть ; воровать 	 steal 	 verb 
 крепкий 	 potent ; strong ; stiff 	 adjective 
 кресло 	 seat 	 house 
 кривая ; дуга 	 curve ; curved shape 	 art 
 крик ; возглас 	 cry ; outcry ; call ; yell ; shout ; vociferation 	 communication 
 критерий 	 standard ; criterion ; measure ; touchstone 	 communication 
 кричать 	 shout ; shout out ; cry ; call ; yell ; scream ; holler ; hollo ; squall 	 verb 
 кровать ; постель 	 bed 	 house 
 кровь 	 blood 	 anatomy 
 кромка ; край 	 edge ; border 	 mathematics 
 круг 	 circle 	 mathematics 
 круг 	 coil ; whorl ; roll ; curl ; curlicue ; ringlet ; gyre ; scroll 	 object 
 круглый 	 round ; circular 	 adjective 
 кругом ; вокруг 	 about ; around 	 adverb 
 крупный ; большой 	 large ; big 	 adjective 
 крутой 	 abrupt ; precipitous ; sharp 	 adjective 
 крыло 	 wing 	 anatomy 
 крыша 	 roof 	 house 
 крышка 	 screen ; cover ; covert ; concealment 	 object 
 крючок 	 hook ; claw 	 object 
 кто 	 who 	 pronoun 
 кубок 	 cup ; loving cup 	 object 
 культура 	 culture ; civilization ; civilisation 	 society 
 купить 	 buy ; purchase 	 verb 
 курить 	 smoke 	 verb 
 курс 	 course ; course of study ; course of instruction ; class 	 education 
 куртка ; пиджак 	 jacket 	 clothes 
 куснуть 	 bite ; seize with teeth 	 verb 
 кусок 	 bit ; chip ; flake ; fleck ; scrap 	 object 
 кусок 	 piece 	 object 
 кусок 	 slice ; piece 	 abstract 
 кухня 	 kitchen 	 house 
 лавка ; магазин 	 shop ; store 	 business 
 ларь 	 chest 	 object 
 лгать 	 lie 	 verb 
 лев 	 lion ; king of beasts ; Panthera leo 	 animal 
 левый 	 left 	 adjective 
 лежать 	 lie 	 verb 
 лезвие 	 blade 	 object 
 лес 	 forest ; wood ; woods 	 nature 
 летание ; полёт 	 flight ; flying 	 transport 
 летать 	 fly ; wing 	 verb 
 лето 	 summer ; summertime 	 nature 
 лечебный 	 medical 	 adjective 
 лечить 	 treat ; care for 	 verb 
 либо 	 either 	 adverb 
 либо 	 whether 	 conjunction 
 лидер 	 leader 	 society 
 листва 	 leaf ; leafage ; foliage 	 nature 
 лифт 	 elevator ; lift 	 device 
 лицо 	 face ; human face 	 anatomy 
 лицо ; человек 	 homo ; man ; human being ; human 	 family 
 лицо ; человек 	 person ; individual ; someone ; somebody ; mortal ; soul 	 family 
 личный 	 personal 	 adjective 
 лоб ; чело 	 brow ; forehead 	 anatomy 
 лодка 	 boat 	 object 
 ложка 	 spoon 	 food 
 ложь 	 lie ; prevarication 	 communication 
 лохань 	 sink 	 house 
 лошадь ; конь 	 horse ; Equus caballus 	 animal 
 лучше 	 better 	 adverb 
 лучше 	 preferably ; sooner ; rather 	 adverb 
 лучший 	 best 	 adjective 
 лучший 	 better 	 adjective 
 любезный 	 kind 	 adjective 
 любить 	 like 	 verb 
 любить 	 love 	 verb 
 любовь 	 love 	 relations 
 любой 	 any ; whatever ; whatsoever 	 adjective 
 люди ; народ 	 people 	 society 
 лягнуть 	 kick 	 verb 
 лёгкий 	 easy 	 adjective 
 лёгкий 	 light 	 adjective 
 лёд 	 ice 	 nature 
 лёд 	 ice ; water ice 	 material 
 маленький 	 small ; little 	 adjective 
 малый 	 fiddling ; footling ; lilliputian ; little ; niggling ; piddling ; piffling ; petty ; picayune ; trivial 	 adjective 
 малый 	 minor ; modest ; small ; small-scale ; pocket-size ; pocket-sized 	 adjective 
 мальчик ; парень 	 male child ; boy 	 family 
 мамочка 	 mother ; female parent 	 family 
 марка 	 brand ; make 	 abstract 
 марка 	 marker ; marking ; mark 	 abstract 
 масло 	 butter 	 food 
 масло 	 oil 	 material 
 масса 	 mass 	 physics 
 материал 	 material ; stuff 	 material 
 материальный 	 material 	 adjective 
 матрос ; моряк 	 sailor ; crewman 	 profession 
 матч 	 match 	 sports 
 мебель 	 furniture ; piece of furniture ; article of furniture 	 house 
 мегаполис 	 city ; metropolis ; urban center 	 society 
 медведь 	 bear 	 animal 
 медленно 	 slowly ; slow ; easy ; tardily 	 adverb 
 медленный 	 slow 	 adjective 
 медсестра ; няня 	 nurse 	 profession 
 между 	 between ; betwixt 	 adverb 
 международный 	 international 	 adjective 
 мелочь 	 change 	 business 
 менструация 	 menstruation ; menses ; menstruum ; catamenia ; period ; flow 	 medicine 
 меньший 	 less 	 adjective 
 меню 	 menu ; bill of fare ; card ; carte du jour ; carte 	 object 
 меня 	 me 	 pronoun 
 мерить 	 measure ; mensurate ; measure out 	 verb 
 мероприятия 	 measure ; step 	 abstract 
 местный 	 local 	 adjective 
 место 	 seat ; place 	 abstract 
 место 	 topographic point ; place ; spot 	 abstract 
 месяц 	 Moon ; moon 	 nature 
 месяц 	 calendar month ; month 	 time 
 месяц 	 month 	 transport 
 металл 	 metallic element ; metal 	 material 
 металлический 	 metallic ; metal 	 adjective 
 метро 	 metro ; tube ; underground ; subway system ; subway 	 transport 
 мешок 	 bag 	 object 
 милиционер 	 policeman ; police officer ; officer 	 profession 
 миллион 	 million ; 1000000 ; one thousand thousand ; meg 	 number 
 мимо 	 by ; past 	 adverb 
 министр 	 minister ; government minister 	 profession 
 минута 	 minute ; min 	 time 
 мир 	 peace 	 abstract 
 мнение ; суждение 	 opinion ; sentiment ; persuasion ; view ; thought 	 communication 
 много 	 many 	 adjective 
 много 	 much 	 adjective 
 множество 	 set 	 mathematics 
 мобильный телефон ; мобильник 	 cellular telephone ; cellular phone ; cellphone ; cell ; mobile phone 	 device 
 мода 	 vogue ; trend ; style 	 abstract 
 модель ; макет 	 model 	 object 
 может быть 	 possibly ; perchance ; perhaps ; maybe ; mayhap ; peradventure 	 adverb 
 мозг 	 brain ; encephalon 	 anatomy 
 мой 	 my 	 pronoun 
 мокрый 	 wet 	 adjective 
 молодой 	 young ; immature 	 adjective 
 молоко 	 milk 	 food 
 молоток 	 hammer 	 object 
 момент 	 while ; piece ; spell ; patch 	 transport 
 момент ; мгновение 	 moment ; minute ; second ; instant 	 mathematics 
 момент ; миг 	 moment ; mo ; minute ; second ; bit 	 time 
 море 	 sea 	 nature 
 мост 	 bridge ; span 	 object 
 мудрый 	 wise 	 adjective 
 муж 	 husband ; hubby ; married man 	 family 
 мужественный 	 male ; manful ; manlike ; manly ; virile 	 adjective 
 мужской 	 male 	 adjective 
 мужчина ; человек 	 man ; adult male 	 family 
 музей 	 museum 	 city 
 музыка 	 music 	 art 
 музыкант 	 musician ; instrumentalist ; player 	 profession 
 муравей 	 ant ; emmet ; pismire 	 animal 
 мускул ; мышца 	 muscle ; musculus 	 anatomy 
 муха 	 fly 	 animal 
 мы 	 we 	 pronoun 
 мыло 	 soap 	 material 
 мысль 	 idea ; thought 	 communication 
 мягкий 	 soft 	 adjective 
 мясо 	 meat 	 food 
 мяч 	 ball 	 object 
 мёртвый 	 dead 	 adjective 
 на 	 at 	 preposition 
 на 	 to 	 preposition 
 набег 	 attack ; onslaught ; onset ; onrush 	 abstract 
 награда 	 award ; accolade ; honor ; honour ; laurels 	 society 
 нагревать 	 warm 	 verb 
 над 	 above ; higher up ; in a higher place ; to a higher place 	 adverb 
 надежда 	 promise ; hope 	 relations 
 надеяться 	 hope 	 verb 
 надпись ; заголовок 	 title 	 society 
 надсада 	 attempt ; effort ; endeavor ; endeavour ; try 	 abstract 
 нажива ; получать доход 	 profit ; turn a profit 	 verb 
 назвать 	 entitle ; title 	 verb 
 назвать 	 name ; call 	 verb 
 наименее 	 least ; to the lowest degree 	 adverb 
 наказание 	 punishment ; penalty ; penalization ; penalisation 	 society 
 наконец 	 last ; lastly ; in conclusion ; finally 	 adverb 
 налогообложение ; налог 	 tax ; taxation ; revenue enhancement 	 business 
 намерение ; цель 	 function ; purpose ; role ; use 	 linguistics 
 наметить 	 plan 	 verb 
 намотать 	 wind ; wrap ; roll ; twine 	 verb 
 намочить 	 wet 	 verb 
 намылить 	 soap ; lather 	 verb 
 напечатать 	 print ; impress 	 verb 
 напиток 	 beverage ; drink ; drinkable ; potable 	 food 
 наполнить 	 fill ; fill up ; make full 	 verb 
 направление 	 direction 	 mathematics 
 нарекание 	 charge ; complaint 	 society 
 народ ; нация 	 nation ; land ; country 	 society 
 наружность ; внешность 	 outside ; exterior 	 mathematics 
 нас 	 us 	 pronoun 
 насахарить ; положить сахару 	 sugar ; saccharify 	 verb 
 насекомые 	 insect 	 animal 
 население 	 population 	 society 
 насильственный 	 violent 	 adjective 
 насквозь 	 through 	 adverb 
 насос 	 pump 	 device 
 настил ; пол 	 floor ; flooring 	 house 
 настоящее 	 present ; nowadays 	 time 
 натуральный 	 natural 	 adjective 
 наука 	 science ; scientific discipline 	 society 
 находить 	 find ; regain 	 verb 
 находка 	 discovery ; breakthrough ; find 	 abstract 
 находка 	 discovery ; find ; uncovering 	 society 
 национальный ; народный 	 national 	 adjective 
 национальный ; народный 	 national 	 adjective 
 начальный 	 inaugural ; initiative ; initiatory ; first ; maiden 	 adjective 
 начинаться 	 get down ; begin ; get ; start out ; start ; set about ; set out ; commence 	 verb 
 наш 	 our 	 pronoun 
 не 	 nor 	 conjunction 
 не любить 	 dislike 	 verb 
 небо 	 sky 	 nature 
 небольшой 	 infinitesimal ; minute 	 adjective 
 недавний 	 recent 	 adjective 
 недавно 	 recently ; late ; lately ; of late ; latterly 	 adverb 
 неделя 	 week ; calendar week 	 time 
 нежирный 	 thin ; lean 	 adjective 
 немедленно 	 immediately ; instantly ; straightaway ; straight off ; directly ; now ; right away ; at once ; forthwith ; like a shot 	 adverb 
 немецкий язык 	 German ; High German ; German language 	 linguistics 
 немного ; мало 	 few 	 adjective 
 немного ; мало 	 little 	 adverb 
 ненавидеть 	 hate ; detest 	 verb 
 ненависть 	 hate ; hatred 	 relations 
 необходимый 	 necessary 	 adjective 
 необыкновенный ; необычный 	 unusual 	 adjective 
 неожиданный 	 sudden 	 adjective 
 непохожий 	 unlike ; dissimilar ; different 	 adjective 
 неправильный 	 false 	 adjective 
 неправильный 	 incorrect ; wrong 	 adjective 
 непременно 	 surely ; certainly ; sure ; for sure ; for certain ; sure enough ; sure as shooting 	 adverb 
 нерв 	 nerve ; nervus 	 anatomy 
 несколько 	 several 	 adjective 
 несмотря 	 despite 	 preposition 
 нести 	 bear 	 verb 
 несчастный случай ; авария 	 accident 	 transport 
 нет 	 no 	 abstract 
 нет 	 not ; non 	 adverb 
 нетерпеливый 	 impatient 	 adjective 
 нефть 	 petroleum ; crude oil ; crude ; rock oil ; fossil oil ; oil 	 material 
 нижний 	 nether ; under 	 adjective 
 низкий ; невысокий 	 low 	 adjective 
 никакой ; никто 	 no 	 adjective 
 никогда 	 never 	 adverb 
 новость 	 news ; intelligence ; tidings ; word 	 society 
 новый 	 new 	 adjective 
 нога 	 leg 	 anatomy 
 ноготь 	 nail 	 anatomy 
 нож 	 knife 	 food 
 ножницы 	 scissors ; pair of scissors 	 object 
 номер ; выпуск 	 issue ; number 	 mathematics 
 нормальный 	 normal 	 adjective 
 нос 	 nose ; olfactory organ 	 anatomy 
 носить 	 wear ; have on 	 verb 
 носок ; гольфы = чулки до колен 	 sock 	 clothes 
 нота 	 note ; musical note ; tone 	 art 
 ночь 	 night ; nighttime ; dark 	 nature 
 ноябрь 	 November ; Nov 	 time 
 нравиться ; любить 	 like 	 verb 
 нудный 	 boring ; deadening ; dull ; ho-hum ; irksome ; slow ; tedious ; tiresome ; wearisome 	 adjective 
 нуль ; ничто ; ничего 	 nothing ; nil ; nix ; nada ; null ; aught ; cipher ; cypher ; goose egg ; naught ; zero ; zilch ; zip ; zippo 	 mathematics 
 о 	 of 	 preposition 
 обвинить 	 charge ; accuse 	 verb 
 обе 	 both 	 adjective 
 обед 	 lunch ; luncheon ; tiffin ; dejeuner 	 food 
 обезьяна 	 monkey 	 animal 
 обеспеченный 	 safe 	 adjective 
 облако 	 cloud 	 nature 
 область низкого давления 	 low ; depression 	 nature 
 обмануть 	 flim-flam ; play a joke on ; play tricks ; trick ; fob ; fox ; pull a fast one on ; play a trick on 	 verb 
 обнаружить 	 detect ; observe ; find ; discover ; notice 	 verb 
 ободрить 	 encourage 	 verb 
 обозначать 	 mean 	 verb 
 обойтись 	 survive ; last ; live ; live on ; go ; endure ; hold up ; hold out 	 verb 
 оборона 	 defense ; defence ; defense force ; defence force 	 abstract 
 обрабатывать 	 function ; work ; operate ; go ; run 	 verb 
 обрадовать 	 please ; delight 	 verb 
 образец 	 blueprint ; design ; pattern 	 object 
 образец 	 prototype ; paradigm ; epitome ; image 	 linguistics 
 образование 	 education 	 education 
 образование 	 education ; instruction ; teaching ; pedagogy ; didactics ; educational activity 	 education 
 обрывистый 	 brusque ; brusk ; curt ; short 	 adjective 
 обследование 	 inquiry ; enquiry ; research 	 abstract 
 обучать 	 teach ; learn ; instruct 	 verb 
 обучение 	 training ; preparation ; grooming 	 abstract 
 обхождение 	 treatment ; handling 	 abstract 
 общественность 	 populace ; public ; world 	 society 
 общественный 	 public 	 travelling 
 общественный 	 social 	 adjective 
 общество 	 company ; companionship ; fellowship ; society 	 society 
 общество 	 society 	 society 
 община 	 community 	 society 
 объяснять 	 explain ; explicate 	 verb 
 обычно 	 by and large ; generally ; more often than not ; mostly 	 adverb 
 обычно 	 normally ; usually ; unremarkably ; commonly ; ordinarily 	 adverb 
 обычный 	 common 	 adjective 
 обычный 	 common ; usual 	 adjective 
 обычный 	 usual 	 adjective 
 овца 	 sheep 	 animal 
 огонь ; пламя 	 fire ; flame ; flaming 	 nature 
 огонь ; пожар 	 fire 	 nature 
 ограничивать 	 restrict ; restrain ; trammel ; limit ; bound ; confine ; throttle 	 verb 
 одежда 	 clothing ; article of clothing ; vesture ; wear ; wearable ; habiliment 	 clothes 
 одежда ; платье 	 apparel ; wearing apparel ; dress ; clothes 	 clothes 
 один 	 one ; 1 ; i ; ane 	 number 
 одинаковый 	 same 	 adjective 
 одиннадцатый 	 eleventh ; 11th 	 number 
 одиннадцать 	 eleven ; 11 ; xi 	 number 
 одинокий 	 alone ; lone ; lonely ; solitary 	 adjective 
 одобрение ; согласие 	 blessing ; approval ; approving 	 communication 
 озеро 	 lake 	 nature 
 оклад ; заработок ; плата 	 income 	 business 
 окно 	 window 	 house 
 окрашенность ; цвет 	 color ; colour ; coloring ; colouring 	 art 
 округлять(ся) 	 round off ; round down ; round out ; round 	 verb 
 окружение 	 environment 	 nature 
 октябрь 	 October ; Oct 	 time 
 она 	 she 	 pronoun 
 они 	 they 	 pronoun 
 опасность 	 danger 	 abstract 
 опасный 	 dangerous ; unsafe 	 adjective 
 операция 	 operation 	 abstract 
 операция 	 operation ; surgery ; surgical operation ; surgical procedure ; surgical process 	 medicine 
 описать 	 describe ; depict ; draw 	 verb 
 оплата 	 wages ; reward ; payoff 	 society 
 опоздавший 	 late 	 adjective 
 опознать 	 identify ; place 	 verb 
 определить ; узнать 	 determine ; check ; find out ; see ; ascertain ; watch ; learn 	 verb 
 определённый 	 particular 	 adjective 
 опыт 	 experience 	 society 
 опытный 	 adept ; expert ; good ; practiced ; proficient ; skillful ; skilful 	 adjective 
 опять 	 again ; once again ; once more ; over again 	 adverb 
 оранжевый 	 orange ; orangish 	 color 
 организация 	 arrangement ; organization ; organisation ; system 	 society 
 организация 	 organization ; organisation 	 society 
 орден 	 order ; monastic order 	 society 
 орех 	 nut 	 food 
 оригинал 	 master ; master copy ; original 	 object 
 оркестр 	 dance band ; band ; dance orchestra 	 art 
 оркестр 	 orchestra 	 art 
 оружие 	 gun 	 object 
 освободить 	 free ; liberate ; release ; unloose ; unloosen ; loose 	 verb 
 осень 	 fall ; autumn 	 nature 
 основа ; база 	 footing ; basis ; ground 	 mathematics 
 основание ; мотив 	 reason ; ground 	 communication 
 основать 	 establish ; found ; plant ; constitute ; institute 	 verb 
 основной 	 basic 	 adjective 
 основной 	 cardinal ; central ; fundamental ; key ; primal 	 adjective 
 особенно 	 particularly ; peculiarly ; especially ; specially 	 adverb 
 особенный 	 especial ; exceptional ; particular ; special 	 adjective 
 оставить 	 leave 	 verb 
 оставить 	 let 	 verb 
 останавить 	 stop ; halt 	 verb 
 остановить 	 stop ; halt 	 abstract 
 остаток 	 remainder ; balance ; residual ; residue ; residuum ; rest 	 business 
 остаться 	 stay ; remain ; rest 	 verb 
 остров 	 island 	 nature 
 острый 	 acuate ; acute ; sharp ; needlelike 	 adjective 
 ответ 	 answer ; reply ; response 	 communication 
 ответственность 	 responsibility ; responsibleness 	 abstract 
 ответственный 	 responsible 	 adjective 
 отвечать ; ответить 	 answer ; reply ; respond 	 verb 
 отделение 	 department ; section 	 society 
 отдельный 	 separate 	 adjective 
 отдых 	 rest ; ease ; repose ; relaxation 	 abstract 
 отдыхать 	 rest 	 verb 
 отказаться 	 refuse ; reject ; pass up ; turn down ; decline 	 verb 
 отклонение 	 deviation ; divergence ; departure ; difference 	 mathematics 
 открытый 	 open ; opened 	 adjective 
 открытый 	 open ; unfastened 	 adjective 
 открыть 	 open ; open up 	 verb 
 отметка 	 mark ; grade ; score 	 education 
 относиться 	 behave ; acquit ; bear ; deport ; conduct ; comport ; carry 	 verb 
 отпуск 	 leave ; leave of absence 	 society 
 отравить 	 poison 	 verb 
 отражать 	 reflect ; reverberate 	 verb 
 отходы 	 waste ; waste material ; waste matter ; waste product 	 material 
 офис ; контора ; канцелярия 	 office ; business office 	 business 
 оценивать 	 rate ; rank ; range ; order ; grade ; place 	 verb 
 оценить 	 estimate ; gauge ; approximate ; guess ; judge 	 verb 
 оценить 	 price 	 verb 
 оценка 	 price 	 transport 
 очевидно 	 obviously ; evidently ; manifestly ; patently ; apparently ; plainly ; plain 	 adverb 
 очень 	 very ; really ; real ; rattling 	 adverb 
 ошибка 	 mistake ; error ; fault 	 communication 
 ошибочный 	 false ; mistaken 	 adjective 
 ощущать ; чуствовать 	 feel ; experience 	 verb 
 ощущение 	 feeling 	 communication 
 падать ; упасть 	 fall 	 verb 
 падение 	 spill ; tumble ; fall 	 abstract 
 пакет 	 package ; bundle ; packet ; parcel 	 object 
 палец 	 finger 	 anatomy 
 палец на ноге 	 toe 	 anatomy 
 палка 	 stick 	 object 
 пальто ; пиджак 	 coat 	 clothes 
 память 	 memory ; retention ; retentiveness ; retentivity 	 communication 
 папа ; отец 	 father ; male parent ; begetter 	 family 
 пар 	 steam 	 physics 
 пара 	 couple ; pair ; twosome ; twain ; brace ; span ; yoke ; couplet ; distich ; duo ; duet ; dyad ; duad 	 number 
 параллельный 	 parallel 	 adjective 
 парк ; сад 	 park ; commons ; common ; green 	 city 
 парус 	 sail ; canvas ; canvass ; sheet 	 object 
 паспорт 	 passport 	 object 
 пассажир 	 passenger ; rider 	 transport 
 пауза ; перерыв 	 respite ; recess ; break ; time out 	 abstract 
 пахать 	 plow ; plough ; turn 	 verb 
 пахнуть 	 smell 	 verb 
 пациент ; больной 	 patient 	 medicine 
 певец 	 singer ; vocalist ; vocalizer ; vocaliser 	 profession 
 первый 	 first 	 adjective 
 первый 	 first ; 1st 	 number 
 перевес 	 dominance ; ascendance ; ascendence ; ascendancy ; ascendency ; control 	 abstract 
 перевозка ; транспорт 	 transportation ; shipping ; transport 	 transport 
 перед 	 ago ; agone 	 adjective 
 передавать 	 pass ; hand ; reach ; pass on ; turn over ; give 	 verb 
 передний 	 front 	 adjective 
 передняя часть 	 front ; front end ; forepart 	 abstract 
 перемена 	 change ; alteration ; modification 	 abstract 
 перенести 	 transport ; carry 	 verb 
 перерыв ; пауза 	 pause ; intermission ; break ; interruption ; suspension 	 time 
 перечень 	 list ; listing 	 abstract 
 период 	 time period ; period of time ; period 	 time 
 перо 	 feather ; plume ; plumage 	 object 
 персонал 	 staff 	 society 
 песня 	 song ; vocal 	 art 
 песок 	 sand 	 material 
 петь 	 sing 	 verb 
 печальный 	 sad 	 adjective 
 печать ;штемпель 	 stamp 	 object 
 печь 	 oven 	 device 
 пиво 	 beer 	 food 
 пилот 	 pilot ; airplane pilot 	 profession 
 пинок 	 kick ; boot ; kicking 	 abstract 
 писатель 	 writer ; author 	 profession 
 писать 	 write 	 verb 
 письменный стол 	 desk 	 house 
 письмо 	 letter ; missive 	 object 
 пить 	 drink ; imbibe 	 verb 
 плавать 	 swim 	 verb 
 плакать 	 cry ; weep 	 verb 
 план 	 plan ; program ; programme 	 abstract 
 плата ; платёж ; уплата 	 payment 	 business 
 платить 	 pay 	 verb 
 плоский 	 flat ; level ; plane 	 adjective 
 плохой 	 bad 	 adjective 
 пляж 	 beach 	 nature 
 победа 	 win 	 sports 
 победить 	 beat ; beat out ; crush ; shell ; trounce ; vanquish 	 verb 
 поблиять 	 affect ; impact ; bear upon ; bear on ; touch on ; touch 	 verb 
 побудить 	 induce ; stimulate ; cause ; have ; get ; make 	 verb 
 повар ; кухарка 	 cook 	 profession 
 поведения 	 demeanor ; demeanour ; behavior ; behaviour ; conduct ; deportment 	 abstract 
 повернуть 	 turn 	 verb 
 поверхность 	 surface 	 mathematics 
 повинность 	 duty 	 abstract 
 повредить 	 damage 	 verb 
 погода 	 weather ; weather condition ; conditions ; atmospheric condition 	 nature 
 подарок 	 present 	 object 
 подбородок 	 chin ; mentum 	 anatomy 
 поддаться 	 surrender ; give up 	 verb 
 поддерживать 	 support ; back up 	 verb 
 поддержка ; опора 	 support 	 abstract 
 подержанный 	 secondhand ; used 	 adjective 
 подключение 	 connection ; connexion ; connector ; connecter ; connective 	 abstract 
 поднять 	 raise ; lift ; elevate ; get up ; bring up 	 verb 
 подобный 	 like ; similar 	 adjective 
 подобный 	 similar 	 adjective 
 подошва 	 foot ; human foot ; pes 	 anatomy 
 подражать 	 imitate ; copy ; simulate 	 verb 
 подробность ; деталь 	 detail ; particular ; item 	 logistics 
 подчиненный 	 subject ; dependent 	 adjective 
 подъём 	 rise ; rising ; ascent ; ascension 	 abstract 
 поезд 	 train ; railroad train 	 transport 
 поездка 	 journey ; journeying 	 transport 
 пожалуйста 	 please 	 adverb 
 пожелать ; хотеть 	 wish 	 verb 
 поздний 	 late ; later 	 adjective 
 поздно 	 late ; belatedly ; tardily 	 adverb 
 позиция ; положение 	 position ; place 	 linguistics 
 показать 	 show ; demo ; exhibit ; present ; demonstrate 	 verb 
 поклонник 	 boyfriend ; fellow ; beau ; swain ; young man 	 family 
 покойник 	 dead 	 society 
 покупатель ; заказчик ; клиент 	 customer ; client 	 business 
 пол 	 sex 	 nature 
 поле 	 field 	 nature 
 полезный ; пригодный 	 useful ; utile 	 adjective 
 политик 	 politician ; politico ; pol ; political leader 	 profession 
 политика 	 policy 	 society 
 политический 	 political 	 adjective 
 полиция 	 police ; police force ; constabulary ; law 	 society 
 полка 	 shelf 	 house 
 полночь 	 midnight 	 time 
 полный 	 full 	 adjective 
 половина 	 one-half ; half 	 mathematics 
 поломка 	 damage ; harm ; impairment 	 transport 
 получать 	 obtain 	 verb 
 получить 	 get ; acquire 	 verb 
 получить 	 receive ; have 	 verb 
 польза 	 advantage ; reward 	 abstract 
 пользователь 	 user 	 society 
 помидор ; томат 	 tomato 	 food 
 помидор ; томат 	 tomato ; love apple ; tomato plant ; Lycopersicon esculentum 	 food 
 помнить 	 remember ; retrieve ; recall ; call back ; call up ; recollect ; think 	 verb 
 помочь 	 help ; aid 	 verb 
 помочь 	 help ; assist ; aid 	 verb 
 помощь ; содействие 	 aid ; assist ; assistance ; help 	 communication 
 понедельник 	 Monday ; Mon 	 time 
 понизу 	 down 	 adjective 
 понимать 	 sympathize ; sympathise ; empathize ; empathise ; understand 	 verb 
 понимать 	 understand 	 verb 
 поперёк 	 across 	 adverb 
 попечение 	 care ; attention ; aid ; tending 	 abstract 
 попробовать 	 try ; seek ; attempt ; essay ; assay 	 verb 
 популярный 	 popular 	 adjective 
 популярный 	 popular ; pop 	 adjective 
 порошок 	 powder ; pulverization ; pulverisation 	 material 
 порядок 	 order 	 linguistics 
 посетить 	 visit ; see 	 verb 
 послать ; отправить 	 mail ; post ; send 	 verb 
 после ; потом 	 after 	 adjective 
 последствие 	 consequence ; effect ; outcome ; result ; event ; issue ; upshot 	 medicine 
 постоянно 	 still 	 adverb 
 поступок ; действие 	 action 	 mathematics 
 поступок ; действие 	 action 	 mathematics 
 поток 	 stream ; flow ; current 	 nature 
 потом 	 subsequently ; later ; afterwards ; afterward ; after ; later on 	 adverb 
 потом ; после 	 then ; so ; and so ; and then 	 adverb 
 потому 	 because 	 conjunction 
 потребность 	 need ; demand 	 abstract 
 поцелуй 	 kiss ; buss ; osculation 	 relations 
 почва ; земля 	 land ; ground ; soil 	 material 
 почему 	 why 	 adverb 
 почерк 	 writing 	 linguistics 
 почта 	 mail ; mail service ; postal service ; post 	 communication 
 почти 	 about ; almost ; most ; nearly ; near ; nigh ; virtually ; well-nigh 	 adverb 
 почтовая марка 	 postage ; postage stamp ; stamp 	 object 
 поэзия 	 poetry ; poesy ; verse 	 art 
 поэтому 	 therefore ; hence ; thence ; thus ; so 	 adverb 
 правило 	 principle ; rule 	 linguistics 
 правило ; предписание 	 rule ; regulation 	 linguistics 
 правильный 	 correct ; right 	 adjective 
 правильный 	 right 	 adjective 
 правильный 	 true 	 adjective 
 правильный ; верный 	 truthful ; true 	 adjective 
 правительство 	 government ; authorities ; regime 	 society 
 править 	 govern ; rule 	 verb 
 право 	 right 	 society 
 правописание ; орфография 	 spelling 	 linguistics 
 правый 	 right 	 adjective 
 практика 	 practice 	 art 
 предложение 	 offer ; offering 	 abstract 
 предложение 	 proposal 	 abstract 
 предложение 	 sentence 	 linguistics 
 предложить 	 design ; plan 	 verb 
 предложить 	 offer 	 verb 
 предложить 	 propose ; suggest ; advise 	 verb 
 предмет ; вещь 	 thing 	 object 
 предоставить 	 supply ; provide ; render ; furnish 	 verb 
 предотвратить 	 prevent ; forestall ; foreclose ; preclude ; forbid 	 verb 
 предполагать 	 suppose ; say 	 verb 
 предприниматель 	 businesswoman 	 business 
 предприятие 	 company 	 business 
 представить 	 introduce ; present ; acquaint 	 verb 
 предыдущий 	 previous ; old 	 adjective 
 президент 	 president 	 profession 
 преимущество 	 advantage ; vantage 	 abstract 
 преодолеть 	 exceed ; transcend ; overstep ; pass ; go past ; top 	 verb 
 преступление 	 crime ; offense ; criminal offense ; criminal offence ; offence ; law-breaking 	 society 
 преуспевать 	 benefit ; do good 	 verb 
 приблизительно 	 approximately ; about ; close to ; just about ; some ; roughly ; more or less ; around ; or so 	 adverb 
 прибыль ; нажива 	 net income ; net ; net profit ; lucre ; profit ; profits ; earnings 	 business 
 привести 	 introduce ; innovate 	 verb 
 привет 	 hello ; hullo ; hi ; howdy ; how-do-you-do 	 linguistics 
 привинтить 	 screw 	 verb 
 приготовить 	 fix ; prepare ; set up ; ready ; gear up ; set 	 verb 
 придать 	 add 	 verb 
 приехать 	 arrive ; make it ; get in ; go far 	 verb 
 приземлиться 	 land ; set down 	 verb 
 приказ ; команда 	 order 	 society 
 приказать 	 order ; tell ; enjoin ; say 	 verb 
 прикосновение 	 touch ; touching 	 abstract 
 пример 	 example ; illustration ; instance ; representative 	 communication 
 принести 	 bring ; convey ; take 	 verb 
 принять 	 accept ; take ; have 	 verb 
 приправить 	 season ; flavor ; flavour 	 verb 
 припустить ; признать 	 admit ; acknowledge 	 verb 
 природа 	 nature 	 nature 
 прирост 	 increase ; increment 	 abstract 
 приходить 	 come ; come up 	 verb 
 прихожая ; вестибюль ; передняя 	 anteroom ; antechamber ; entrance hall ; hall ; foyer ; lobby ; vestibule 	 house 
 причина 	 cause 	 abstract 
 причина 	 reason 	 communication 
 проблема 	 issue 	 communication 
 проблема 	 problem ; job 	 mathematics 
 проблема 	 trouble ; problem 	 abstract 
 проверка 	 control 	 abstract 
 провод 	 wire 	 object 
 проводить ; практиковать 	 practice ; practise ; exercise ; do 	 verb 
 провозглашение ; объявление 	 announcement ; proclamation ; annunciation ; declaration 	 communication 
 программа 	 program ; programme ; computer program ; computer programme 	 abstract 
 продажа ; сбыт 	 sale 	 business 
 продать 	 sell 	 verb 
 продолжать 	 continue ; go on ; proceed ; go along ; keep 	 verb 
 продукт 	 product ; production 	 object 
 проект 	 design ; designing 	 abstract 
 проект 	 project ; projection 	 abstract 
 проект 	 suggestion ; proposition ; proffer 	 abstract 
 проект 	 undertaking ; project ; task ; labor 	 abstract 
 проиграть 	 lose 	 verb 
 производство 	 production 	 abstract 
 произношение 	 pronunciation 	 linguistics 
 промахнуться 	 miss 	 verb 
 промышленность 	 industry ; manufacture 	 society 
 промышленный ; индустриальный 	 industrial 	 adjective 
 проницательный 	 astute ; sharp ; shrewd 	 adjective 
 пропаганда ; реклама ; объявление 	 ad ; advertisement ; advertizement ; advertising ; advertizing ; advert 	 business 
 просить 	 request ; bespeak ; call for ; quest 	 verb 
 простить 	 forgive 	 verb 
 просто ; только 	 merely ; simply ; just ; only ; but 	 adverb 
 простой 	 elementary ; simple ; uncomplicated ; unproblematic 	 adjective 
 пространство 	 area ; expanse ; surface area 	 mathematics 
 простуда ; насморк 	 cold ; common cold 	 medicine 
 просьба 	 request ; asking 	 communication 
 протест 	 protest ; protestation 	 communication 
 против 	 against 	 preposition 
 противоположность 	 reverse ; contrary ; opposite 	 abstract 
 противоположный 	 opposite 	 adjective 
 профессионал 	 professional ; professional person 	 profession 
 профессиональный 	 professional 	 adjective 
 профессия ; работа 	 occupation ; business ; job ; line of work ; line 	 business 
 проходить 	 spend ; pass 	 verb 
 процент 	 interest 	 business 
 процент 	 percentage ; percent ; per centum ; pct 	 mathematics 
 процесс 	 process ; physical process 	 nature 
 процесс ; процедура 	 procedure ; process 	 mathematics 
 прошлое 	 past ; past times ; yesteryear 	 time 
 прошлый 	 last 	 adjective 
 прошлый 	 past 	 adjective 
 пружина 	 spring 	 object 
 прыгать ; скакать 	 jump ; leap ; bound ; spring 	 verb 
 прямо 	 directly ; straight ; direct 	 adverb 
 прямой 	 straight 	 adjective 
 птица 	 bird 	 animal 
 пчела 	 bee 	 animal 
 пыль 	 dust 	 material 
 пятнадцать 	 fifteen ; 15 ; xv 	 number 
 пятница 	 Friday ; Fri 	 time 
 пятый 	 fifth ; 5th 	 number 
 пять 	 five ; 5 ; v 	 number 
 пятьдесят 	 fifty ; 50 ; l 	 number 
 работа 	 work 	 abstract 
 работать 	 work 	 verb 
 рабочий 	 worker 	 profession 
 равнина 	 plain ; field ; champaign 	 nature 
 равный ; одинаковый 	 equal 	 adjective 
 радоваться 	 enjoy ; bask ; relish ; savor ; savour 	 verb 
 раз 	 once ; one time ; in one case 	 adverb 
 разбитый 	 broken 	 adjective 
 разбить 	 break 	 verb 
 развиваться 	 develop 	 verb 
 разговор ; беседа ; диалог 	 interview 	 communication 
 разгромить 	 crush 	 verb 
 разделение 	 division ; partition ; partitioning ; segmentation ; sectionalization ; sectionalisation 	 mathematics 
 разделить 	 divide ; split ; split up ; separate ; dissever ; carve up 	 verb 
 разделять 	 share 	 verb 
 раздробление 	 crush ; crunch ; compaction 	 abstract 
 различный 	 diverse ; various 	 adjective 
 размер 	 size 	 physics 
 разница 	 difference 	 abstract 
 разнообразность ; разнообразие ; пестрота 	 diverseness ; diversity ; multifariousness ; variety 	 art 
 разоблачить ; открыть 	 unwrap ; disclose ; let on ; bring out ; reveal ; discover ; expose ; divulge ; break ; give away ; let out 	 verb 
 разозлённый 	 angry 	 adjective 
 разрешить 	 let ; allow ; permit 	 verb 
 разрушение 	 destruction ; devastation 	 abstract 
 разумный ; интеллигентный 	 intelligent 	 adjective 
 район 	 region ; part 	 nature 
 рамка 	 frame 	 object 
 ранг ; класс 	 class ; form ; grade ; course 	 art 
 ранить 	 hurt ; injure 	 verb 
 ранить 	 injure ; wound 	 verb 
 ранний ; скорый 	 early 	 adjective 
 рапорт 	 report ; study ; written report 	 abstract 
 расстояние 	 distance 	 mathematics 
 рассуждать 	 reason 	 verb 
 растение 	 plant ; flora ; plant life 	 house 
 расти 	 grow 	 verb 
 расход 	 cost 	 society 
 расценка ; тариф 	 rate ; charge per unit 	 business 
 реакция 	 reaction 	 abstract 
 ребёнок 	 baby ; babe ; infant 	 family 
 ребёнок 	 child ; kid 	 nature 
 регулярный 	 regular 	 adjective 
 редкий 	 sparse ; thin 	 adjective 
 резать 	 cut 	 verb 
 резкий 	 fierce ; tearing ; vehement ; violent ; trigger-happy 	 adjective 
 результат 	 result ; resultant ; final result ; outcome ; termination 	 mathematics 
 река 	 river 	 nature 
 рекорд 	 record 	 abstract 
 религия 	 religion ; faith ; organized religion 	 society 
 рельс 	 track ; rail ; rails ; runway 	 transport 
 ресторан 	 restaurant ; eating house ; eating place ; eatery 	 city 
 речь 	 language ; speech 	 linguistics 
 решить 	 decide ; make up one's mind ; determine 	 verb 
 рис 	 rice 	 food 
 рис 	 rice 	 food 
 риск 	 hazard ; jeopardy ; peril ; risk ; endangerment 	 transport 
 рисковать 	 gamble ; chance ; risk ; hazard ; take chances ; adventure ; run a risk ; take a chance 	 verb 
 рисовать 	 trace ; draw ; line ; describe ; delineate 	 verb 
 ритм 	 rhythm ; beat ; musical rhythm 	 art 
 ровный 	 even ; fifty-fifty 	 adjective 
 родитель 	 parent 	 family 
 родство 	 relationship ; human relationship 	 society 
 рождение 	 birth ; nativity ; nascency ; nascence 	 nature 
 розоватый ; розовый 	 pink ; pinkish 	 color 
 рост 	 increase ; increment ; growth 	 abstract 
 рот 	 mouth 	 anatomy 
 рубашка 	 shirt 	 clothes 
 рука 	 arm 	 anatomy 
 рука 	 hand ; manus ; mitt ; paw 	 anatomy 
 руководство ; предводительство 	 management ; direction 	 society 
 русский язык 	 Russian 	 language 
 ручка 	 handle ; grip ; handgrip ; hold 	 object 
 ручка 	 pen 	 object 
 рыба 	 fish 	 animal 
 рынок ; базар 	 market ; marketplace ; market place 	 business 
 с 	 since 	 preposition 
 с 	 with 	 preposition 
 сад 	 garden 	 house 
 салат 	 salad 	 food 
 сам 	 entirely ; exclusively ; solely ; alone ; only 	 adverb 
 самец 	 male ; male person 	 society 
 самолёт 	 airplane ; aeroplane ; plane 	 object 
 сандвич ; бутерброд 	 sandwich 	 food 
 сахар 	 sugar ; refined sugar 	 food 
 сведениe ; информация 	 data ; information 	 communication 
 сведениe ; информация 	 information 	 communication 
 сведениe ; информация 	 information ; info 	 communication 
 свежий 	 fresh 	 adjective 
 свет 	 light ; visible light ; visible radiation 	 nature 
 свет ; мир 	 world 	 nature 
 светлый 	 bright ; brilliant ; vivid 	 adjective 
 свинец 	 lead ; Pb ; atomic number 82 	 material 
 свинья 	 hog ; pig ; grunter ; squealer ; Sus scrofa 	 animal 
 свободный 	 free 	 adjective 
 свой 	 own ; ain 	 adjective 
 сделка 	 bargain ; deal 	 business 
 себе 	 herself 	 pronoun 
 себя 	 himself 	 pronoun 
 себя 	 itself 	 pronoun 
 себя 	 yourself 	 pronoun 
 север 	 north ; due north ; northward ; N 	 logistics 
 северный 	 north 	 adjective 
 сегодня 	 today 	 adverb 
 сегодня вечером 	 tonight ; this evening ; this night 	 adverb 
 сегодняшний день ; сегодня 	 today 	 time 
 седьмой 	 seventh ; 7th 	 number 
 сейф 	 safe 	 object 
 сейчас 	 now 	 time 
 сейчас 	 right 	 adverb 
 секрет ; тайна 	 secret 	 communication 
 секретарь ; секретарша 	 secretary ; secretarial assistant 	 profession 
 секретный 	 clandestine ; cloak-and-dagger ; hole-and-corner ; hugger-mugger ; hush-hush ; secret ; surreptitious ; undercover ; underground 	 adjective 
 секс 	 sexual activity ; sexual practice ; sex ; sex activity 	 relations 
 секунда 	 second ; sec ; s 	 time 
 секция ; отделение 	 part ; section ; division 	 mathematics 
 секция ; участок 	 section ; subdivision 	 mathematics 
 семнадцать 	 seventeen ; 17 ; xvii 	 number 
 семь 	 seven ; 7 ; vii 	 number 
 семьдесят 	 seventy ; 70 ; lxx 	 number 
 семья 	 family ; family unit 	 family 
 семья 	 family ; household ; house ; home ; menage 	 family 
 сердце 	 heart ; pump ; ticker 	 anatomy 
 серебро 	 silver ; Ag ; atomic number 47 	 material 
 серебряный 	 argent ; silver ; silvery ; silverish 	 adjective 
 серебряный 	 silver 	 adjective 
 середина ; средняя часть 	 center ; centre ; middle ; heart ; eye 	 mathematics 
 сериал ; многосерийный фильм 	 serial ; series 	 abstract 
 серый 	 gray ; grayness ; grey ; greyness 	 color 
 серый 	 grey ; gray ; greyish ; grayish 	 adjective 
 серьёзный 	 serious 	 adjective 
 сестра 	 sister ; sis 	 family 
 сжать ; нажать 	 press 	 verb 
 сзади ; позади 	 behind 	 adverb 
 сигнализировать 	 bespeak ; betoken ; indicate ; point ; signal 	 verb 
 сидеть 	 sit ; sit down 	 verb 
 сила 	 force ; forcefulness ; strength 	 abstract 
 сила 	 might ; mightiness ; power 	 abstract 
 сила 	 power ; powerfulness 	 abstract 
 сильный 	 strong 	 adjective 
 символизировать 	 represent ; stand for ; correspond 	 verb 
 система 	 system ; scheme 	 linguistics 
 ситуация 	 situation ; state of affairs 	 abstract 
 скала 	 rock ; stone 	 nature 
 скачок ; прыжок 	 leap ; jump ; saltation 	 abstract 
 скверный 	 hateful ; mean 	 adjective 
 скворзь 	 across ; crosswise ; crossways 	 adverb 
 склон 	 gradient ; slope 	 mathematics 
 скоро 	 early on ; early 	 adverb 
 скоро 	 soon ; shortly ; presently ; before long 	 adverb 
 скромный 	 private 	 adjective 
 сладкое 	 sweet 	 adjective 
 сладкое ; пирожное 	 cake 	 food 
 сладость 	 sweet ; sweetness ; sugariness 	 food 
 следовать 	 follow 	 verb 
 следующий 	 following ; next 	 adjective 
 словарь 	 dictionary ; lexicon 	 linguistics 
 слово 	 word 	 linguistics 
 сложение 	 summation ; addition ; plus 	 mathematics 
 слон 	 elephant 	 animal 
 слуга 	 servant ; retainer 	 profession 
 служить 	 serve 	 verb 
 случай 	 case ; instance ; example 	 abstract 
 случай 	 event ; case 	 abstract 
 случиться 	 happen ; hap ; go on ; pass off ; occur ; pass ; fall out ; come about ; take place 	 verb 
 слушать 	 listen ; hear ; take heed 	 verb 
 слышать 	 hear 	 verb 
 смерть 	 death 	 nature 
 смерть 	 death ; decease ; expiry 	 abstract 
 смеяться 	 laugh ; express joy ; express mirth 	 verb 
 смотреть 	 look 	 verb 
 смотреть 	 watch ; view ; see ; catch ; take in 	 verb 
 смять 	 squash ; crush ; squelch ; mash ; squeeze 	 verb 
 снаружи 	 outside 	 adverb 
 сначала 	 first ; firstly ; foremost ; first of all ; first off 	 adverb 
 снег 	 snow 	 nature 
 снег 	 snow ; snowfall 	 nature 
 собака 	 dog ; domestic dog ; Canis familiaris 	 animal 
 собственник ; владелец ; обладатель 	 owner ; possessor 	 business 
 событие 	 event 	 abstract 
 совет 	 advice 	 communication 
 совет 	 council 	 society 
 совместный 	 common ; mutual 	 adjective 
 современный 	 current 	 adjective 
 современный 	 mod ; modern ; modernistic 	 adjective 
 современный 	 modern 	 adjective 
 современный ; настойащий 	 present 	 adjective 
 согласиться 	 agree ; hold ; concur ; concord 	 verb 
 соглашение ; договор ;контракт ; урегулирование 	 agreement ; understanding 	 business 
 соединение 	 connection ; connexion ; connectedness 	 abstract 
 соединить 	 associate ; tie in ; relate ; link ; colligate ; link up ; connect 	 verb 
 соединить(ся) 	 join ; bring together 	 verb 
 сознающий 	 conscious ; witting 	 adjective 
 сократить 	 displace ; fire ; give notice ; can ; dismiss ; give the axe ; send away ; sack ; force out ; give the sack ; terminate 	 verb 
 сократить 	 reduce ; cut down ; cut back ; trim ; trim down ; trim back ; cut ; bring down 	 verb 
 солдат 	 soldier 	 profession 
 солить 	 salt 	 verb 
 солнце 	 sun ; Sun 	 nature 
 соль 	 salt ; table salt ; common salt 	 food 
 сомневаться 	 doubt 	 verb 
 сомнение ; неуверенность 	 doubt ; uncertainty ; incertitude ; dubiety ; doubtfulness ; dubiousness 	 communication 
 сон 	 sleep ; slumber 	 nature 
 сообщать 	 report 	 verb 
 сообщить 	 announce ; denote 	 verb 
 соотношение 	 relation 	 communication 
 соперник 	 rival ; challenger ; competitor ; competition ; contender 	 business 
 соревнование ; состязание 	 contest ; competition 	 society 
 сорок 	 forty ; 40 ; xl ; twoscore 	 number 
 сортировать 	 classify ; class ; sort ; assort ; sort out ; separate 	 verb 
 сосед 	 neighbor ; neighbour 	 family 
 соседний 	 adjacent ; next ; side by side 	 adjective 
 составлять фактуру ; засчитывать 	 charge ; bill 	 verb 
 состояние 	 condition ; status 	 abstract 
 состояние 	 state 	 mathematics 
 сосчитать 	 add ; add together 	 verb 
 соус 	 sauce 	 food 
 сохранить 	 keep ; maintain ; hold 	 verb 
 союз 	 union 	 society 
 спалить 	 burn ; fire ; burn down 	 verb 
 спальня 	 bedroom ; sleeping room ; sleeping accommodation ; chamber ; bedchamber 	 house 
 спасти 	 salvage ; salve ; relieve ; save 	 verb 
 специалист 	 expert 	 profession 
 специфический 	 specific 	 adjective 
 спичка 	 match ; lucifer ; friction match 	 object 
 сплетение 	 net ; network ; mesh ; meshing ; meshwork 	 material 
 спокойствие 	 repose ; quiet ; placidity ; serenity ; tranquillity ; tranquility 	 abstract 
 спор 	 controversy ; contention ; contestation ; disputation ; disceptation ; tilt ; argument ; arguing 	 mathematics 
 спорить 	 argue ; contend ; debate ; fence 	 verb 
 способ 	 means ; agency ; way 	 abstract 
 способ ; метод 	 method 	 mathematics 
 способ ; метод ; стиль 	 manner ; mode ; style ; way ; fashion 	 mathematics 
 способность 	 ability ; power 	 abstract 
 способность 	 feature ; characteristic 	 abstract 
 способность 	 property 	 abstract 
 способный 	 able 	 adjective 
 справедливый 	 just 	 adjective 
 справиться 	 cope ; get by ; make out ; make do ; contend ; grapple ; deal ; manage 	 verb 
 спрашивать 	 ask ; inquire ; enquire 	 verb 
 сравнение 	 comparison ; comparing 	 abstract 
 сравнивать 	 compare 	 verb 
 среда 	 Wednesday ; Midweek ; Wed 	 time 
 среда ; окружающая среда 	 environment ; environs ; surroundings ; surround 	 nature 
 среди 	 among ; amongst ; amid ; amidst 	 preposition 
 среднее 	 mean ; mean value 	 mathematics 
 срез 	 cut ; cutting 	 abstract 
 стакан 	 glass ; drinking glass 	 food 
 сталь 	 steel 	 material 
 стандартный 	 standard 	 adjective 
 станок 	 machine 	 device 
 станция 	 station 	 society 
 старание 	 effort ; elbow grease ; exertion ; travail ; sweat 	 abstract 
 старт 	 beginning ; commencement ; first ; outset ; get-go ; start ; kickoff ; starting time ; showtime ; offset 	 abstract 
 старый 	 old 	 adjective 
 стать 	 become ; go ; get 	 verb 
 стебель 	 stalk ; stem 	 nature 
 стежок 	 stitch 	 medicine 
 стекло 	 glass 	 material 
 стена 	 wall 	 house 
 степень 	 degree 	 linguistics 
 стиль 	 style 	 art 
 стихотворение ; поэма 	 poem ; verse form 	 art 
 сто 	 hundred ; one hundred ; 100 ; c 	 number 
 стоимость ; цена 	 price ; cost ; toll 	 business 
 стол 	 table 	 house 
 столица 	 capital 	 society 
 сторож 	 lookout ; lookout man ; sentinel ; sentry ; watch ; spotter ; scout ; picket 	 profession 
 сторона 	 side 	 mathematics 
 стоять 	 stand ; stand up 	 verb 
 страна 	 country ; state ; land 	 society 
 страна 	 state 	 society 
 страна ; государство 	 state ; province 	 society 
 страница 	 page 	 object 
 странный 	 strange ; unusual 	 adjective 
 страх 	 fear ; fearfulness ; fright 	 relations 
 страховка 	 insurance 	 business 
 стрелять 	 open fire ; fire 	 verb 
 строить 	 construct ; build ; make 	 verb 
 стройка 	 structure ; construction 	 house 
 структура 	 structure 	 linguistics 
 струя 	 current ; electric current 	 nature 
 студент ; ученик 	 student ; pupil ; educatee 	 profession 
 стул 	 chair 	 house 
 ступень 	 step ; stair 	 house 
 суббота 	 Saturday ; Sabbatum ; Sat 	 time 
 суд 	 court ; tribunal ; judicature 	 society 
 судно ; корабль 	 ship 	 transport 
 судья 	 judge ; justice ; jurist 	 profession 
 сумка ; сумочка 	 bag ; handbag ; pocketbook ; purse 	 clothes 
 суп 	 soup 	 food 
 супермаркет ; универсам 	 supermarket 	 city 
 суть 	 kernel ; substance ; core ; center ; centre ; essence ; gist ; heart ; heart and soul ; inwardness ; marrow ; meat ; nub ; pith ; sum ; nitty-gritty 	 abstract 
 сухой 	 dry 	 adjective 
 существование 	 being ; beingness ; existence 	 society 
 схватить 	 catch ; grab ; take hold of 	 verb 
 сходиться 	 match ; fit ; correspond ; check ; jibe ; gibe ; tally ; agree 	 verb 
 сцена 	 stage 	 object 
 счастливый 	 happy 	 adjective 
 счастливый 	 lucky 	 adjective 
 считать 	 see ; consider ; reckon ; view ; regard 	 verb 
 счёт 	 account ; business relationship 	 business 
 сын 	 son ; boy 	 family 
 сыр 	 cheese 	 food 
 сюда 	 here ; hither 	 adverb 
 сюжет ; тема 	 subject ; topic ; theme 	 linguistics 
 сюрприз 	 surprise 	 abstract 
 таблица 	 table ; tabular array 	 object 
 так ; таким образом 	 so 	 adverb 
 такой 	 such 	 adverb 
 такса 	 charge 	 business 
 там 	 there ; at that place ; in that location 	 adverb 
 танцевать 	 dance ; trip the light fantastic ; trip the light fantastic toe 	 verb 
 тарелка 	 plate 	 food 
 творить 	 make ; create 	 verb 
 твёрдый ; жёсткий 	 firm ; solid 	 adjective 
 театр 	 theater ; theatre ; house 	 city 
 телевизор 	 television receiver ; television ; television set ; tv ; tv set ; idiot box ; boob tube ; telly ; goggle box 	 device 
 телесный ; физический 	 physical 	 adjective 
 тенденция 	 tendency ; trend 	 abstract 
 теннис 	 tennis ; lawn tennis 	 sports 
 теория 	 theory 	 education 
 теперь ; сейчас 	 now ; at present 	 adverb 
 терпеливый 	 patient 	 adjective 
 терпеть 	 suffer ; endure 	 verb 
 терять 	 lose 	 verb 
 тесный 	 tight 	 adjective 
 технология 	 engineering ; engineering science ; applied science ; technology 	 abstract 
 технология 	 technology ; engineering 	 society 
 течение ; поток 	 current ; stream 	 nature 
 тип 	 type 	 abstract 
 тихий 	 quiet 	 adjective 
 тихий 	 silent ; soundless ; still 	 adjective 
 тишина 	 silence ; quiet 	 abstract 
 ткань 	 fabric ; cloth ; material ; textile 	 material 
 толкнуть 	 push ; force 	 verb 
 толстый 	 fat 	 adjective 
 толстый 	 thick 	 adjective 
 торговать 	 trade ; merchandise 	 verb 
 торс 	 torso ; trunk ; body 	 anatomy 
 тот 	 that 	 pronoun 
 точка 	 point ; dot 	 linguistics 
 точка зрения 	 attitude ; mental attitude 	 abstract 
 точно 	 precisely ; exactly ; just 	 adverb 
 точно 	 right 	 adverb 
 трава 	 grass 	 nature 
 требование 	 claim 	 society 
 требовать 	 necessitate ; ask ; postulate ; need ; require ; take ; involve ; call for ; demand 	 verb 
 третий 	 third ; 3rd ; tertiary 	 mathematics 
 три 	 three ; 3 ; iii 	 number 
 тридцать 	 thirty ; 30 ; xxx 	 number 
 тринадцать 	 thirteen ; 13 ; xiii 	 number 
 труба 	 pipe ; pipage ; piping 	 object 
 трудность 	 difficulty 	 abstract 
 трудный 	 difficult ; hard 	 adjective 
 трудный 	 heavy 	 adjective 
 трюк 	 trick 	 abstract 
 тысяча 	 thousand ; one thousand ; 1000 ; M ; K ; chiliad ; G ; grand ; thou ; yard 	 number 
 тысяча 	 thousand ; one thousand ; 1000 ; m ; k 	 number 
 тюрьма ; заточение 	 prison ; prison house 	 city 
 тянуть 	 pull ; draw ; force 	 verb 
 тёмный 	 dark 	 adjective 
 тёплый 	 warm 	 adjective 
 убить 	 kill 	 verb 
 уборная ; туалет 	 toilet ; lavatory ; lav ; can ; john ; privy ; bathroom 	 house 
 убрать 	 remove ; take ; take away ; withdraw 	 verb 
 увеличивать(ся) 	 increase 	 verb 
 увеличить 	 enhance ; heighten ; raise 	 verb 
 углевод 	 carbohydrate ; saccharide ; sugar 	 food 
 угол 	 angle 	 mathematics 
 уголь 	 coal 	 material 
 удар 	 blow 	 abstract 
 удар 	 hit ; hitting ; striking 	 abstract 
 удар 	 jolt ; jar ; jounce ; shock 	 transport 
 ударить 	 smash ; nail ; boom ; blast 	 verb 
 удивить 	 surprise 	 verb 
 удовольствие 	 pleasure ; pleasance 	 abstract 
 удоствоверение 	 pass ; laissez passer 	 object 
 уже 	 already 	 adverb 
 узел 	 knot 	 object 
 узкий 	 narrow 	 adjective 
 узкий 	 thin 	 adjective 
 узнавать 	 discover ; find 	 verb 
 уйти 	 exit ; go out ; get out ; leave 	 verb 
 уклониться ; избежать 	 avoid 	 verb 
 укус 	 bite 	 medicine 
 улика 	 evidence 	 abstract 
 улица 	 street 	 city 
 улучшить 	 better ; improve ; amend ; ameliorate ; meliorate 	 verb 
 улыбаться 	 smile 	 verb 
 улыбка 	 smile ; smiling ; grin ; grinning 	 abstract 
 ум, мысль 	 mind ; head ; brain ; psyche ; nous 	 mathematics 
 умереть 	 die ; decease ; perish ; go ; exit ; pass away ; expire ; pass ; kick the bucket ; cash in one's chips ; buy the farm ; conk ; give-up the ghost ; drop dead ; pop off ; choke ; croak ; snuff it 	 verb 
 университет ; вуз 	 university 	 city 
 университет ; вуз 	 university 	 city 
 университет ; вуз 	 university 	 education 
 употребление 	 use ; usage ; utilization ; utilisation ; employment ; exercise 	 linguistics 
 управление ; менеджмент 	 management 	 business 
 управлять 	 operate ; control 	 verb 
 упустить 	 miss 	 verb 
 уровень 	 degree ; grade ; level 	 linguistics 
 услуга 	 service 	 sports 
 успех 	 success 	 society 
 успешный 	 successful 	 adjective 
 уста ; рот 	 mouth ; oral cavity ; oral fissure ; rima oris 	 anatomy 
 усталый 	 tired 	 adjective 
 установленный 	 laid ; set 	 adjective 
 утверждение 	 claim 	 communication 
 утверждения 	 statement 	 communication 
 утрата ; пропадание ; урон 	 loss 	 business 
 утро 	 morning ; morn ; morning time ; forenoon 	 time 
 ухо 	 ear 	 anatomy 
 участок ; область ; район 	 stretch 	 art 
 учитель 	 teacher ; instructor 	 profession 
 учитывать 	 respect ; honor ; honour ; abide by ; observe 	 verb 
 учить(ся) 	 learn ; larn ; acquire 	 verb 
 учреждение 	 institution ; establishment 	 society 
 учёный 	 scientist 	 profession 
 фаза 	 phase ; stage 	 time 
 факт 	 fact 	 abstract 
 фактура ; счёт 	 bill ; account ; invoice 	 business 
 фальшивый 	 fake ; false ; faux ; imitation ; simulated 	 adjective 
 февраль 	 February ; Feb 	 time 
 ферма 	 farm 	 nature 
 физический 	 physical 	 adjective 
 фильм 	 film ; cinema ; celluloid 	 object 
 фильм ; кинокартина 	 movie ; film ; picture ; moving picture ; moving-picture show ; motion picture ; motion-picture show ; picture show ; pic ; flick 	 art 
 финансовый 	 fiscal ; financial 	 adjective 
 фиолетовый ; тёмно-лиловый 	 purple ; violet ; purplish 	 color 
 фирма ; торговый дом 	 firm ; house ; business firm 	 business 
 флаг 	 flag 	 object 
 формуляр 	 form 	 society 
 фотоаппарат 	 camera ; photographic camera 	 object 
 фотограф 	 photographer ; lensman 	 profession 
 францьзскый язык 	 French 	 language 
 фрукты 	 fruit 	 food 
 функция 	 function ; office ; part ; role 	 mathematics 
 футбол 	 football ; football game 	 sports 
 характер 	 personality 	 abstract 
 хвост 	 tail 	 anatomy 
 химикат 	 chemical ; chemical substance 	 material 
 химический 	 chemical ; chemic 	 adjective 
 химия 	 chemistry ; chemical science 	 science 
 хинди 	 Hindi 	 language 
 хит 	 hit ; smash ; smasher ; strike ; bang 	 art 
 хлеб 	 bread ; breadstuff ; staff of life 	 food 
 хлопок 	 cotton 	 material 
 хлопок 	 cotton ; cotton fiber ; cotton wool 	 material 
 ходить 	 travel ; go ; move ; locomote 	 verb 
 хозяйство ; экономика 	 economy ; economic system 	 business 
 холод 	 coldness ; cold ; low temperature ; frigidity ; frigidness 	 nature 
 холодный 	 cold 	 adjective 
 холостой ; незамужняя 	 unmarried ; single 	 adjective 
 хороший ; хорошая 	 good ; well 	 adjective 
 хороший ; хорошо 	 good 	 adjective 
 хорошо 	 well ; good 	 adverb 
 хотеть 	 desire ; want 	 verb 
 хотя 	 however ; nevertheless ; withal ; still ; yet ; all the same ; even so ; nonetheless ; notwithstanding 	 adverb 
 хрупкий 	 delicate ; fragile ; frail 	 adjective 
 художник 	 artist ; creative person 	 profession 
 цапфа 	 pivot ; pin 	 object 
 цветной 	 color ; colour 	 adjective 
 цветок 	 flower 	 nature 
 целовать 	 snog ; kiss ; buss ; osculate 	 verb 
 целое 	 whole 	 abstract 
 цель 	 finish ; destination ; goal 	 abstract 
 цена 	 price ; terms ; damage 	 transport 
 ценность 	 value 	 art 
 центр 	 center ; centre ; midpoint 	 mathematics 
 центральный 	 central 	 adjective 
 цепь 	 chain 	 object 
 церковь ; храм 	 church ; church building 	 city 
 цитировать 	 mention ; advert ; bring up ; cite ; name ; refer 	 verb 
 чай 	 tea 	 food 
 час 	 hour ; hr ; 60 minutes 	 time 
 часто 	 frequently ; often ; oftentimes ; oft ; ofttimes 	 adverb 
 частый 	 frequent 	 adjective 
 часть 	 part ; portion ; component part ; component ; constituent 	 abstract 
 часть 	 share ; portion ; part ; percentage 	 society 
 часы 	 clock 	 device 
 часы 	 watch ; ticker 	 object 
 чашка 	 cup 	 food 
 чей 	 whose 	 pronoun 
 чек 	 check ; bank check ; cheque 	 business 
 чем 	 than 	 conjunction 
 чемодан 	 bag ; traveling bag ; travelling bag ; grip ; suitcase 	 clothes 
 чемпионат 	 championship ; title 	 sports 
 чернила 	 ink 	 material 
 черта ; линия 	 line 	 mathematics 
 честный 	 good ; just ; upright 	 adjective 
 четверг 	 Thursday ; Th 	 time 
 четвёртый 	 fourth ; 4th ; quaternary 	 number 
 четыре 	 four ; 4 ; iv 	 number 
 четырнадцать 	 fourteen ; 14 ; xiv 	 number 
 чиновник 	 officeholder ; officer 	 profession 
 чистить 	 clean ; make clean 	 verb 
 чистить 	 skin ; peel ; pare 	 verb 
 чистый 	 clean 	 adjective 
 читать 	 read 	 verb 
 член 	 member ; fellow member 	 society 
 чувствовать 	 feel ; sense 	 verb 
 чуять 	 smell 	 verb 
 чёрный 	 black 	 adjective 
 чётный 	 even 	 adjective 
 шаг ; поступь 	 footstep ; pace ; step ; stride 	 mathematics 
 шахта 	 mine 	 object 
 шестнадцать 	 sixteen ; 16 ; xvi 	 number 
 шестой 	 sixth ; 6th 	 number 
 шесть 	 six ; 6 ; vi ; half dozen ; half-dozen 	 number 
 шестьдесят 	 sixty ; 60 ; lx ; threescore 	 number 
 шеф 	 head ; chief ; top dog 	 society 
 шея ; горло 	 neck ; cervix 	 anatomy 
 широкий 	 wide ; broad 	 adjective 
 шить 	 sew ; run up ; sew together ; stitch 	 verb 
 шкаф 	 cupboard ; closet 	 house 
 школа 	 school 	 city 
 школа 	 school ; schoolhouse 	 city 
 шляпа 	 hat ; chapeau ; lid 	 clothes 
 шок 	 daze ; shock ; stupor 	 abstract 
 шокировать 	 shock ; offend ; scandalize ; scandalise ; appal ; appall ; outrage 	 verb 
 шоколад 	 chocolate 	 food 
 шоу 	 show 	 abstract 
 шум ; гам 	 noise ; dissonance ; racket 	 society 
 шёлк ; шелк 	 silk 	 material 
 щепетильный 	 dainty ; nice ; overnice ; prissy ; squeamish 	 adjective 
 щётка 	 brush 	 object 
 эволюция ; развитие 	 development ; evolution 	 nature 
 экзамен 	 examination ; exam ; test 	 communication 
 экономический 	 economic 	 adjective 
 экономический 	 economic ; economical 	 adjective 
 экспресс 	 express ; limited 	 transport 
 элегантный 	 stylish ; fashionable 	 adjective 
 электрический 	 electric ; electrical 	 adjective 
 элемент 	 chemical element ; element 	 material 
 элемент 	 component ; constituent ; element ; factor ; ingredient 	 mathematics 
 энергия 	 energy ; free energy 	 nature 
 эта 	 this 	 pronoun 
 этаж 	 floor ; level ; storey ; story 	 house 
 эти 	 these 	 pronoun 
 эти 	 those 	 pronoun 
 это 	 it 	 pronoun 
 юбка 	 skirt 	 clothes 
 юг 	 south ; due south ; southward ; S 	 logistics 
 южный 	 south 	 adjective 
 юмор 	 humor ; humour ; sense of humor ; sense of humour 	 communication 
 юноша ; паренёк 	 child ; kid ; youngster ; minor ; shaver ; nipper ; small fry ; tiddler ; tike ; tyke ; fry ; nestling 	 family 
 яблоко 	 apple 	 food 
 явный 	 clear 	 adjective 
 яд ; отрава 	 poison ; toxicant ; poisonous substance 	 material 
 язык 	 language ; linguistic communication 	 communication 
 язык 	 natural language ; tongue 	 linguistics 
 язык 	 speech ; speech communication ; spoken communication ; spoken language ; language ; voice communication ; oral communication 	 linguistics 
 язык 	 tongue ; lingua ; glossa ; clapper 	 anatomy 
 яйцо 	 egg 	 food 
 январь 	 January ; Jan 	 time 
 японский язык 	 Japanese 	 language 
 ясно 	 clearly 	 adverb 
 ячейка ; клетка 	 cell 	 anatomy 
 ящик 	 drawer 	 house 
